"","ID","gender","ethnicity","grade","specialEducation","prevTestScore","pastDisciplinary","socialBehavior","academicBehavior","emotionalBehavior","totalBehavior","trsSocialBehavior","trsAcademicBehavior","trsEmotionalBehavior","trsTotalBehavior","midasRisk","futureTestScore","futureDisciplinary"
"1",657,"female","Black or African American",6,"No",44,"Yes",6,14,19,39,11,4,1,16,5,70,"Yes"
"2",477,"female","American Indian or Alaska Native",8,"Yes",92,"No",9,17,19,45,6,11,16,33,35,78,"Yes"
"3",680,"male","Black or African American",8,"No",77,"Yes",9,16,16,41,15,10,21,46,28,76,"Yes"
"4",32,"male","White",6,"No",49,"Yes",14,12,15,41,16,10,14,40,16,44,"Yes"
"5",578,"male","American Indian or Alaska Native",8,"Yes",79,"No",9,8,21,38,18,18,8,44,13,74,"Yes"
"6",165,"male","Native Hawaiian or Other Pacific Islander",6,"No",14,"Yes",15,17,8,40,2,13,7,22,35,11,"Yes"
"7",78,"female","American Indian or Alaska Native",8,"No",49,"Yes",13,15,12,40,12,18,18,48,33,47,"Yes"
"8",870,"female","White",7,"No",87,"No",18,17,11,46,6,16,20,42,40,84,"No"
"9",549,"female","American Indian or Alaska Native",7,"Yes",24,"Yes",18,16,17,51,17,6,17,40,21,12,"No"
"10",333,"female","American Indian or Alaska Native",7,"No",69,"No",11,13,18,42,13,11,20,44,6,16,"Yes"
"11",557,"female","Black or African American",8,"Yes",80,"No",15,15,5,35,13,16,5,34,24,78,"Yes"
"12",694,"female","Asian",6,"No",44,"No",3,12,9,24,15,14,17,46,50,39,"Yes"
"13",134,"male","American Indian or Alaska Native",7,"Yes",32,"No",8,18,10,36,15,18,21,54,8,60,"Yes"
"14",730,"male","Black or African American",8,"No",9,"Yes",16,15,14,45,14,14,14,42,11,99,"Yes"
"15",718,"male","White",7,"No",96,"No",12,17,17,46,13,12,18,43,50,89,"Yes"
"16",100,"male","White",6,"No",89,"No",16,6,14,36,18,17,17,52,23,97,"No"
"17",161,"female","White",6,"No",44,"Yes",13,15,13,41,18,13,17,48,4,88,"No"
"18",940,"male","Black or African American",8,"No",86,"Yes",15,10,11,36,7,13,9,29,21,58,"No"
"19",679,"male","Black or African American",8,"No",45,"No",11,12,8,31,1,4,14,19,11,85,"No"
"20",308,"female","Asian",8,"No",58,"Yes",17,13,12,42,17,7,7,31,46,89,"No"
"21",982,"female","American Indian or Alaska Native",7,"Yes",36,"Yes",8,3,15,26,11,18,21,50,17,53,"Yes"
"22",296,"male","White",8,"Yes",99,"Yes",16,17,16,49,2,3,18,23,13,75,"Yes"
"23",902,"male","White",7,"Yes",68,"No",13,16,19,48,14,11,3,28,25,88,"No"
"24",831,"female","Asian",8,"No",69,"Yes",17,14,20,51,17,7,14,38,37,92,"No"
"25",658,"male","Black or African American",6,"Yes",97,"Yes",18,12,10,40,15,12,5,32,28,91,"No"
"26",299,"male","Asian",6,"No",89,"No",18,18,19,55,18,15,16,49,30,70,"Yes"
"27",626,"female","White",6,"No",47,"No",13,18,20,51,2,17,13,32,37,76,"No"
"28",243,"female","Native Hawaiian or Other Pacific Islander",8,"Yes",93,"No",16,18,8,42,11,14,18,43,38,89,"Yes"
"29",504,"female","Native Hawaiian or Other Pacific Islander",6,"No",81,"No",11,10,15,36,18,10,14,42,8,57,"No"
"30",708,"male","Black or African American",8,"No",59,"Yes",10,10,19,39,15,11,14,40,44,55,"No"
"31",11,"female","White",6,"Yes",28,"Yes",10,13,18,41,18,17,18,53,24,68,"Yes"
"32",646,"female","Native Hawaiian or Other Pacific Islander",6,"No",49,"Yes",10,14,19,43,16,11,21,48,43,26,"Yes"
"33",968,"female","Native Hawaiian or Other Pacific Islander",7,"Yes",47,"No",14,9,6,29,18,17,16,51,47,48,"No"
"34",834,"female","White",8,"Yes",97,"No",15,11,17,43,10,12,19,41,49,61,"No"
"35",20,"female","Asian",8,"No",90,"Yes",12,11,19,42,18,10,17,45,13,30,"No"
"36",771,"male","White",8,"No",59,"Yes",16,16,13,45,10,8,13,31,10,58,"No"
"37",762,"female","Native Hawaiian or Other Pacific Islander",6,"Yes",89,"Yes",12,8,17,37,10,6,12,28,34,99,"No"
"38",364,"male","American Indian or Alaska Native",6,"No",98,"Yes",17,5,11,33,11,14,19,44,8,94,"No"
"39",60,"female","White",6,"Yes",90,"No",12,5,21,38,15,16,14,45,25,22,"Yes"
"40",511,"female","White",7,"No",17,"No",18,10,15,43,14,14,15,43,48,9,"Yes"
"41",330,"male","White",8,"No",69,"Yes",16,14,19,49,15,8,7,30,24,78,"Yes"
"42",4,"female","American Indian or Alaska Native",8,"No",97,"Yes",12,8,16,36,18,9,10,37,22,87,"Yes"
"43",101,"male","Black or African American",6,"No",96,"No",13,3,21,37,5,16,16,37,2,58,"No"
"44",280,"male","Asian",7,"Yes",52,"No",16,11,9,36,7,4,4,15,27,79,"No"
"45",360,"female","Native Hawaiian or Other Pacific Islander",8,"No",66,"No",13,10,18,41,16,18,13,47,41,94,"No"
"46",598,"female","Native Hawaiian or Other Pacific Islander",6,"No",84,"No",17,14,6,37,15,12,11,38,49,84,"No"
"47",927,"male","Asian",7,"No",88,"No",11,16,15,42,15,18,12,45,30,73,"Yes"
"48",985,"female","American Indian or Alaska Native",8,"No",40,"No",18,17,17,52,14,4,17,35,26,43,"Yes"
"49",244,"female","Native Hawaiian or Other Pacific Islander",7,"Yes",47,"No",5,17,17,39,5,15,13,33,2,62,"Yes"
"50",860,"male","Asian",7,"No",16,"Yes",17,12,14,43,10,7,15,32,31,69,"No"
"51",700,"male","White",8,"No",48,"No",14,16,4,34,14,14,19,47,39,87,"Yes"
"52",214,"male","White",8,"Yes",64,"Yes",12,14,18,44,9,12,16,37,1,30,"No"
"53",257,"male","Asian",8,"Yes",8,"Yes",5,4,7,16,15,15,18,48,49,75,"Yes"
"54",489,"female","Black or African American",7,"Yes",69,"No",13,18,16,47,5,11,18,34,45,84,"Yes"
"55",801,"female","White",6,"Yes",32,"No",12,15,18,45,15,18,15,48,24,37,"No"
"56",456,"male","Asian",6,"No",86,"Yes",15,18,20,53,11,8,12,31,44,59,"No"
"57",518,"male","Native Hawaiian or Other Pacific Islander",6,"No",86,"No",17,15,6,38,18,13,16,47,31,99,"No"
"58",691,"male","Black or African American",7,"Yes",94,"No",2,13,9,24,10,15,5,30,39,61,"Yes"
"59",120,"female","American Indian or Alaska Native",7,"No",68,"No",12,16,19,47,8,18,12,38,41,77,"Yes"
"60",620,"female","Native Hawaiian or Other Pacific Islander",6,"No",49,"Yes",15,6,19,40,2,11,10,23,2,62,"No"
"61",281,"female","Asian",8,"Yes",76,"Yes",15,14,4,33,15,9,19,43,16,25,"Yes"
"62",373,"male","Native Hawaiian or Other Pacific Islander",6,"No",90,"No",12,18,10,40,15,5,2,22,7,41,"No"
"63",648,"female","White",7,"No",97,"Yes",10,5,19,34,3,8,12,23,49,40,"Yes"
"64",976,"female","Asian",8,"No",76,"Yes",8,12,17,37,13,18,8,39,21,100,"No"
"65",508,"male","White",6,"No",65,"Yes",16,17,18,51,18,17,17,52,11,88,"Yes"
"66",425,"male","Native Hawaiian or Other Pacific Islander",6,"Yes",71,"No",11,17,14,42,12,12,12,36,39,32,"Yes"
"67",267,"female","White",7,"Yes",88,"No",10,5,16,31,12,13,4,29,10,15,"Yes"
"68",212,"female","American Indian or Alaska Native",6,"Yes",92,"Yes",6,17,6,29,17,7,16,40,29,75,"Yes"
"69",219,"male","Native Hawaiian or Other Pacific Islander",7,"Yes",63,"No",12,10,20,42,17,5,13,35,5,66,"Yes"
"70",462,"female","American Indian or Alaska Native",7,"Yes",49,"No",13,13,8,34,17,15,21,53,10,71,"No"
"71",825,"male","Asian",7,"Yes",37,"No",16,8,15,39,14,6,20,40,16,19,"Yes"
"72",215,"male","White",8,"No",76,"Yes",14,13,5,32,16,4,12,32,21,80,"Yes"
"73",815,"male","Black or African American",8,"Yes",91,"No",17,12,16,45,15,7,16,38,1,90,"No"
"74",351,"female","Asian",8,"Yes",65,"Yes",17,13,12,42,2,14,21,37,3,35,"No"
"75",495,"male","American Indian or Alaska Native",8,"Yes",81,"Yes",18,14,13,45,13,13,21,47,39,90,"No"
"76",767,"female","Black or African American",6,"No",88,"Yes",4,16,15,35,12,10,12,34,15,92,"No"
"77",113,"male","Black or African American",7,"Yes",69,"Yes",17,16,2,35,15,5,13,33,22,77,"Yes"
"78",525,"female","White",6,"Yes",50,"No",15,14,3,32,16,11,20,47,41,75,"Yes"
"79",862,"male","Asian",6,"Yes",46,"Yes",18,18,8,44,17,12,16,45,35,46,"No"
"80",6,"female","Asian",7,"No",31,"No",11,9,20,40,11,8,4,23,22,18,"No"
"81",770,"female","Asian",7,"No",66,"Yes",12,3,12,27,16,7,4,27,30,55,"Yes"
"82",408,"female","Native Hawaiian or Other Pacific Islander",7,"No",28,"No",15,9,19,43,17,12,21,50,45,90,"No"
"83",977,"female","White",6,"No",89,"No",16,14,7,37,9,6,10,25,27,72,"No"
"84",443,"male","White",8,"Yes",95,"No",14,16,20,50,17,8,15,40,41,44,"Yes"
"85",258,"male","Asian",7,"No",26,"Yes",8,17,6,31,15,16,19,50,42,51,"No"
"86",536,"female","American Indian or Alaska Native",7,"Yes",62,"Yes",16,18,19,53,16,3,20,39,1,42,"Yes"
"87",798,"female","Black or African American",7,"Yes",59,"Yes",14,3,13,30,16,13,21,50,20,13,"No"
"88",856,"male","Black or African American",7,"Yes",52,"Yes",18,8,10,36,15,14,13,42,48,68,"No"
"89",349,"female","Black or African American",6,"No",39,"No",13,11,16,40,15,1,12,28,34,86,"No"
"90",576,"male","American Indian or Alaska Native",8,"No",67,"No",17,17,16,50,15,16,11,42,3,93,"No"
"91",814,"male","American Indian or Alaska Native",7,"Yes",100,"No",16,4,20,40,4,10,18,32,49,61,"No"
"92",158,"female","Black or African American",7,"Yes",68,"No",8,8,21,37,17,15,19,51,25,65,"Yes"
"93",118,"male","White",7,"No",92,"Yes",10,17,13,40,12,12,10,34,21,28,"No"
"94",160,"male","White",7,"No",81,"No",12,12,16,40,17,3,12,32,14,67,"No"
"95",895,"female","White",8,"Yes",82,"No",14,9,20,43,18,6,17,41,4,54,"Yes"
"96",604,"female","Asian",6,"Yes",37,"Yes",13,6,18,37,18,18,12,48,8,47,"Yes"
"97",455,"male","White",6,"Yes",61,"Yes",15,16,11,42,18,3,21,42,36,49,"No"
"98",200,"female","Asian",8,"Yes",63,"No",6,14,20,40,17,18,17,52,20,72,"Yes"
"99",882,"female","Asian",7,"Yes",33,"Yes",14,11,13,38,16,11,14,41,17,59,"No"
"100",663,"male","Native Hawaiian or Other Pacific Islander",8,"Yes",57,"Yes",18,16,16,50,14,1,21,36,45,51,"Yes"
"101",722,"female","Asian",8,"Yes",84,"Yes",16,14,20,50,8,12,13,33,36,87,"No"
"102",188,"male","White",6,"Yes",98,"No",3,17,14,34,17,10,13,40,20,80,"Yes"
"103",650,"female","Native Hawaiian or Other Pacific Islander",7,"No",78,"No",16,7,18,41,10,18,21,49,10,28,"No"
"104",143,"female","Native Hawaiian or Other Pacific Islander",8,"No",27,"No",10,17,11,38,18,18,10,46,36,94,"No"
"105",552,"female","Native Hawaiian or Other Pacific Islander",7,"Yes",86,"Yes",16,7,19,42,13,18,9,40,22,62,"Yes"
"106",675,"male","American Indian or Alaska Native",8,"No",80,"Yes",7,12,13,32,14,18,21,53,40,56,"Yes"
"107",530,"male","Asian",6,"No",25,"Yes",7,18,16,41,8,15,19,42,20,71,"No"
"108",936,"female","Native Hawaiian or Other Pacific Islander",7,"Yes",51,"No",9,13,19,41,16,11,8,35,47,78,"Yes"
"109",424,"female","White",8,"Yes",82,"No",11,1,16,28,17,13,5,35,12,91,"Yes"
"110",547,"female","Native Hawaiian or Other Pacific Islander",8,"No",86,"Yes",6,16,9,31,15,7,19,41,38,66,"Yes"
"111",65,"female","American Indian or Alaska Native",6,"Yes",48,"No",14,17,12,43,9,16,12,37,2,81,"No"
"112",481,"male","White",6,"Yes",60,"No",13,14,21,48,10,18,18,46,8,72,"Yes"
"113",328,"female","Native Hawaiian or Other Pacific Islander",6,"No",99,"Yes",12,4,12,28,15,9,13,37,3,82,"No"
"114",95,"male","Black or African American",7,"No",55,"Yes",13,5,5,23,13,3,17,33,7,85,"No"
"115",611,"male","Asian",8,"Yes",83,"Yes",14,11,20,45,7,9,15,31,24,39,"No"
"116",628,"male","Black or African American",8,"No",91,"Yes",16,16,2,34,8,12,15,35,25,51,"Yes"
"117",48,"female","American Indian or Alaska Native",8,"Yes",66,"No",13,14,20,47,10,12,13,35,43,44,"No"
"118",119,"male","Black or African American",7,"No",55,"Yes",13,15,10,38,2,2,18,22,27,73,"Yes"
"119",329,"male","Black or African American",6,"No",73,"Yes",7,14,13,34,18,16,20,54,10,91,"Yes"
"120",805,"male","American Indian or Alaska Native",6,"No",67,"No",9,4,19,32,10,10,19,39,36,46,"No"
"121",992,"male","Asian",8,"No",34,"No",2,9,19,30,15,11,20,46,25,80,"No"
"122",47,"male","White",7,"No",95,"Yes",14,8,6,28,11,17,16,44,25,51,"Yes"
"123",836,"female","Asian",7,"Yes",90,"No",5,18,16,39,17,11,9,37,40,61,"Yes"
"124",516,"female","White",6,"No",78,"No",5,15,7,27,15,5,18,38,40,45,"No"
"125",262,"female","White",8,"No",79,"Yes",4,3,13,20,4,12,17,33,32,98,"Yes"
"126",361,"female","Asian",7,"No",51,"No",15,18,19,52,14,16,20,50,26,65,"Yes"
"127",630,"female","White",6,"Yes",70,"No",11,14,11,36,10,6,10,26,49,62,"Yes"
"128",5,"male","Asian",6,"No",99,"No",11,18,10,39,18,16,20,54,42,45,"Yes"
"129",45,"female","Black or African American",7,"Yes",50,"Yes",6,17,18,41,16,4,11,31,6,64,"No"
"130",826,"male","Native Hawaiian or Other Pacific Islander",6,"Yes",54,"Yes",5,15,13,33,11,10,21,42,14,72,"No"
"131",745,"male","Asian",6,"Yes",60,"Yes",13,15,16,44,6,11,10,27,31,78,"Yes"
"132",479,"male","Black or African American",6,"No",17,"No",12,9,6,27,16,5,8,29,14,72,"No"
"133",950,"female","Native Hawaiian or Other Pacific Islander",7,"Yes",38,"Yes",9,7,11,27,12,12,8,32,8,52,"Yes"
"134",423,"female","Black or African American",8,"Yes",52,"Yes",18,16,20,54,4,18,20,42,43,79,"Yes"
"135",73,"male","Asian",7,"Yes",41,"Yes",9,11,11,31,15,17,16,48,21,73,"Yes"
"136",796,"male","American Indian or Alaska Native",7,"Yes",75,"No",13,13,13,39,15,1,12,28,8,49,"Yes"
"137",951,"female","Native Hawaiian or Other Pacific Islander",8,"Yes",96,"Yes",11,10,17,38,18,18,9,45,45,23,"No"
"138",468,"female","Asian",7,"No",91,"No",10,17,18,45,10,18,21,49,14,72,"No"
"139",724,"male","American Indian or Alaska Native",8,"Yes",88,"Yes",17,13,12,42,12,10,16,38,43,36,"No"
"140",2,"male","Black or African American",7,"No",89,"Yes",15,6,21,42,15,17,18,50,8,46,"No"
"141",9,"male","American Indian or Alaska Native",7,"No",11,"No",14,7,20,41,3,12,17,32,40,92,"Yes"
"142",703,"female","White",6,"No",33,"Yes",11,18,8,37,8,14,10,32,16,69,"No"
"143",382,"female","White",7,"No",81,"Yes",15,16,15,46,15,10,15,40,34,99,"Yes"
"144",50,"male","American Indian or Alaska Native",6,"No",79,"No",6,13,21,40,12,2,18,32,1,91,"Yes"
"145",193,"female","Asian",7,"Yes",27,"Yes",17,17,19,53,14,2,16,32,41,45,"No"
"146",758,"female","Asian",7,"Yes",78,"No",9,14,10,33,12,12,14,38,14,91,"No"
"147",135,"male","White",7,"Yes",85,"No",13,13,19,45,15,17,17,49,22,40,"Yes"
"148",944,"female","Asian",6,"No",91,"No",7,10,5,22,15,10,21,46,18,53,"Yes"
"149",490,"male","Native Hawaiian or Other Pacific Islander",7,"No",44,"Yes",16,11,14,41,16,18,12,46,36,97,"No"
"150",181,"female","Native Hawaiian or Other Pacific Islander",7,"No",100,"Yes",15,16,2,33,7,11,9,27,7,37,"Yes"
"151",173,"male","Black or African American",8,"Yes",79,"No",14,18,17,49,14,8,21,43,36,99,"No"
"152",928,"male","Native Hawaiian or Other Pacific Islander",8,"No",92,"No",2,18,21,41,13,14,10,37,42,71,"No"
"153",137,"female","White",6,"Yes",77,"Yes",2,12,17,31,11,9,18,38,14,12,"Yes"
"154",809,"female","Asian",7,"Yes",63,"Yes",15,10,17,42,16,18,17,51,16,23,"No"
"155",551,"female","White",8,"No",69,"Yes",6,4,12,22,17,7,10,34,21,66,"No"
"156",692,"female","White",7,"Yes",63,"No",6,15,21,42,12,16,14,42,32,92,"No"
"157",605,"female","Black or African American",6,"No",19,"No",13,17,17,47,14,8,13,35,10,58,"No"
"158",622,"male","Black or African American",8,"No",63,"Yes",16,12,18,46,18,15,13,46,2,80,"Yes"
"159",532,"female","Asian",7,"Yes",36,"No",18,16,20,54,17,14,20,51,17,89,"No"
"160",398,"male","White",8,"No",62,"Yes",14,18,7,39,15,2,16,33,14,53,"Yes"
"161",581,"male","Native Hawaiian or Other Pacific Islander",8,"Yes",97,"Yes",6,13,17,36,16,13,17,46,36,53,"Yes"
"162",99,"female","Native Hawaiian or Other Pacific Islander",8,"No",8,"Yes",16,16,4,36,12,13,10,35,33,77,"Yes"
"163",164,"male","White",8,"Yes",94,"No",17,17,11,45,14,15,11,40,46,88,"No"
"164",470,"female","White",8,"No",87,"No",2,18,19,39,5,15,21,41,44,69,"No"
"165",326,"female","Asian",8,"No",96,"No",17,5,20,42,11,14,7,32,34,44,"Yes"
"166",857,"male","Black or African American",7,"No",91,"Yes",18,12,19,49,12,6,20,38,40,90,"No"
"167",702,"male","American Indian or Alaska Native",7,"Yes",86,"Yes",15,18,11,44,9,11,11,31,39,95,"No"
"168",579,"male","White",6,"Yes",74,"No",18,14,14,46,16,7,17,40,46,49,"Yes"
"169",635,"male","Native Hawaiian or Other Pacific Islander",8,"No",24,"No",18,14,14,46,14,9,19,42,9,99,"Yes"
"170",888,"male","American Indian or Alaska Native",6,"No",91,"Yes",9,16,21,46,16,18,12,46,42,14,"No"
"171",228,"male","White",7,"Yes",34,"No",11,4,20,35,6,18,9,33,22,58,"No"
"172",954,"male","Black or African American",8,"No",83,"Yes",18,10,18,46,15,16,19,50,17,66,"Yes"
"173",921,"female","American Indian or Alaska Native",8,"No",99,"No",13,18,6,37,12,14,12,38,19,85,"Yes"
"174",432,"male","White",6,"No",63,"No",14,15,2,31,10,10,12,32,28,50,"Yes"
"175",705,"male","Native Hawaiian or Other Pacific Islander",7,"Yes",50,"No",13,9,14,36,17,14,14,45,1,75,"No"
"176",197,"female","American Indian or Alaska Native",7,"Yes",95,"Yes",18,5,16,39,15,9,10,34,40,74,"No"
"177",224,"female","Asian",7,"Yes",72,"Yes",9,13,19,41,14,10,13,37,10,92,"No"
"178",829,"male","Asian",6,"No",18,"Yes",9,17,11,37,6,9,5,20,19,93,"No"
"179",569,"female","Native Hawaiian or Other Pacific Islander",6,"Yes",74,"No",14,6,20,40,15,17,6,38,39,75,"Yes"
"180",368,"female","Black or African American",8,"No",88,"No",13,15,17,45,17,13,14,44,24,87,"No"
"181",546,"male","White",7,"Yes",79,"No",18,11,21,50,15,18,21,54,38,89,"No"
"182",467,"male","Black or African American",7,"No",35,"Yes",8,7,13,28,17,15,17,49,15,95,"Yes"
"183",463,"male","White",7,"Yes",52,"Yes",9,2,21,32,13,16,14,43,13,100,"No"
"184",252,"female","American Indian or Alaska Native",7,"Yes",91,"Yes",17,13,11,41,12,18,21,51,29,99,"No"
"185",908,"female","White",6,"Yes",88,"Yes",15,15,18,48,16,18,13,47,3,48,"Yes"
"186",254,"female","Native Hawaiian or Other Pacific Islander",7,"Yes",39,"Yes",16,14,14,44,18,10,14,42,47,50,"Yes"
"187",896,"male","White",8,"No",94,"No",16,15,7,38,9,12,21,42,24,78,"Yes"
"188",475,"male","American Indian or Alaska Native",6,"Yes",80,"Yes",13,12,17,42,16,2,12,30,5,19,"No"
"189",661,"male","White",8,"No",93,"Yes",7,14,16,37,11,16,19,46,46,66,"No"
"190",736,"female","Black or African American",7,"Yes",95,"Yes",15,15,16,46,17,17,4,38,25,69,"Yes"
"191",793,"female","White",8,"No",63,"Yes",15,15,20,50,6,17,16,39,26,87,"No"
"192",279,"male","Black or African American",6,"No",41,"No",12,9,15,36,17,13,20,50,31,83,"No"
"193",42,"female","Asian",6,"Yes",75,"Yes",17,10,21,48,12,17,20,49,9,92,"No"
"194",457,"male","Native Hawaiian or Other Pacific Islander",8,"No",47,"No",12,15,20,47,17,10,17,44,11,35,"No"
"195",269,"female","White",6,"No",99,"Yes",9,16,14,39,6,12,16,34,47,84,"Yes"
"196",625,"male","Black or African American",7,"No",85,"Yes",12,15,6,33,13,18,21,52,19,76,"No"
"197",846,"male","American Indian or Alaska Native",7,"Yes",84,"No",15,13,14,42,18,13,19,50,4,81,"No"
"198",29,"female","Native Hawaiian or Other Pacific Islander",7,"Yes",100,"No",15,11,3,29,9,17,15,41,38,93,"No"
"199",606,"male","American Indian or Alaska Native",8,"Yes",62,"Yes",13,11,15,39,10,8,16,34,26,61,"Yes"
"200",879,"male","White",7,"Yes",99,"Yes",10,9,14,33,15,5,18,38,16,57,"Yes"
"201",261,"male","White",8,"Yes",58,"Yes",12,11,12,35,10,18,13,41,23,34,"No"
"202",238,"female","American Indian or Alaska Native",6,"Yes",77,"No",12,13,9,34,15,7,17,39,22,79,"No"
"203",919,"female","American Indian or Alaska Native",8,"No",49,"No",12,15,18,45,4,10,15,29,31,91,"No"
"204",838,"male","Native Hawaiian or Other Pacific Islander",7,"No",77,"Yes",14,14,2,30,15,16,7,38,50,61,"No"
"205",656,"female","Black or African American",7,"Yes",94,"Yes",10,15,12,37,4,18,17,39,21,98,"No"
"206",54,"male","White",8,"Yes",89,"Yes",3,12,17,32,8,14,8,30,20,93,"No"
"207",79,"female","American Indian or Alaska Native",8,"No",88,"No",4,4,13,21,14,8,20,42,10,87,"Yes"
"208",385,"male","Native Hawaiian or Other Pacific Islander",7,"No",19,"No",14,15,10,39,14,14,16,44,38,55,"Yes"
"209",595,"male","American Indian or Alaska Native",8,"Yes",85,"Yes",18,7,21,46,17,13,5,35,30,91,"No"
"210",603,"male","Black or African American",8,"No",69,"No",15,17,20,52,18,8,21,47,27,66,"No"
"211",236,"female","Native Hawaiian or Other Pacific Islander",7,"No",81,"No",9,17,17,43,3,10,10,23,21,92,"No"
"212",85,"female","Asian",7,"Yes",18,"No",14,11,14,39,16,10,17,43,33,10,"No"
"213",899,"male","Native Hawaiian or Other Pacific Islander",8,"Yes",98,"No",12,15,6,33,17,10,14,41,28,62,"Yes"
"214",402,"female","Native Hawaiian or Other Pacific Islander",7,"No",70,"Yes",10,11,21,42,8,3,21,32,38,43,"No"
"215",677,"male","American Indian or Alaska Native",7,"No",33,"No",17,8,21,46,7,12,12,31,20,41,"Yes"
"216",52,"male","American Indian or Alaska Native",7,"Yes",67,"No",7,18,9,34,4,12,19,35,17,72,"No"
"217",206,"female","White",6,"No",86,"Yes",12,14,15,41,11,9,19,39,12,51,"Yes"
"218",643,"male","Native Hawaiian or Other Pacific Islander",7,"Yes",85,"Yes",11,18,15,44,12,15,9,36,14,59,"Yes"
"219",130,"female","Black or African American",7,"Yes",17,"Yes",18,8,15,41,18,7,13,38,43,91,"No"
"220",325,"female","Native Hawaiian or Other Pacific Islander",8,"Yes",60,"No",5,8,9,22,9,17,19,45,41,41,"No"
"221",144,"male","White",8,"Yes",47,"No",18,7,20,45,4,18,9,31,3,69,"No"
"222",71,"male","Asian",8,"No",64,"Yes",8,18,14,40,10,17,6,33,49,53,"Yes"
"223",80,"male","White",7,"Yes",84,"Yes",16,18,21,55,11,1,4,16,50,88,"Yes"
"224",875,"female","Black or African American",6,"No",68,"Yes",17,14,19,50,16,10,11,37,1,59,"No"
"225",223,"female","American Indian or Alaska Native",8,"Yes",80,"No",18,18,18,54,7,15,5,27,12,94,"No"
"226",121,"female","Asian",7,"No",85,"No",18,16,12,46,18,14,18,50,15,54,"Yes"
"227",226,"female","Native Hawaiian or Other Pacific Islander",7,"No",87,"No",1,14,11,26,13,15,18,46,25,49,"Yes"
"228",565,"male","Native Hawaiian or Other Pacific Islander",8,"No",35,"Yes",14,10,15,39,14,2,12,28,25,46,"Yes"
"229",684,"male","American Indian or Alaska Native",6,"No",96,"Yes",15,9,17,41,18,13,17,48,12,33,"No"
"230",707,"male","Native Hawaiian or Other Pacific Islander",6,"No",81,"No",16,17,18,51,18,13,13,44,4,30,"No"
"231",660,"female","Black or African American",7,"No",93,"Yes",6,12,20,38,12,3,13,28,18,78,"Yes"
"232",789,"male","Asian",7,"No",12,"No",10,13,20,43,12,7,1,20,17,90,"No"
"233",515,"male","White",8,"No",34,"No",13,18,7,38,16,10,12,38,40,61,"Yes"
"234",502,"female","Native Hawaiian or Other Pacific Islander",6,"No",68,"No",15,11,6,32,11,16,9,36,10,45,"Yes"
"235",292,"male","Native Hawaiian or Other Pacific Islander",6,"No",66,"Yes",3,13,16,32,15,12,20,47,31,24,"No"
"236",961,"male","Black or African American",8,"No",29,"Yes",14,13,13,40,17,9,21,47,17,100,"Yes"
"237",929,"male","American Indian or Alaska Native",6,"No",50,"Yes",18,12,10,40,16,11,21,48,36,53,"No"
"238",828,"male","Black or African American",6,"Yes",81,"No",15,16,15,46,5,10,21,36,35,96,"Yes"
"239",990,"female","Asian",8,"No",64,"Yes",16,12,15,43,17,16,20,53,11,70,"No"
"240",202,"male","Asian",7,"No",22,"Yes",12,17,6,35,15,17,2,34,47,54,"No"
"241",994,"male","Native Hawaiian or Other Pacific Islander",7,"No",90,"Yes",17,17,9,43,15,14,5,34,40,76,"Yes"
"242",559,"male","Native Hawaiian or Other Pacific Islander",7,"Yes",88,"Yes",9,10,17,36,16,17,7,40,17,84,"No"
"243",33,"male","American Indian or Alaska Native",6,"No",98,"Yes",11,6,21,38,8,17,9,34,20,96,"Yes"
"244",422,"female","White",7,"No",81,"Yes",17,14,19,50,12,13,21,46,45,86,"No"
"245",627,"female","Asian",7,"No",57,"Yes",8,14,11,33,16,12,6,34,39,97,"Yes"
"246",911,"male","American Indian or Alaska Native",8,"No",91,"Yes",8,14,10,32,13,14,12,39,27,56,"No"
"247",619,"female","White",6,"Yes",63,"No",5,14,19,38,10,13,7,30,38,98,"No"
"248",46,"female","Native Hawaiian or Other Pacific Islander",6,"Yes",75,"Yes",11,6,19,36,17,16,19,52,24,98,"No"
"249",185,"female","Black or African American",7,"Yes",71,"No",9,8,13,30,9,15,13,37,8,22,"No"
"250",469,"female","Asian",6,"No",67,"Yes",17,3,20,40,18,17,6,41,12,60,"No"
"251",687,"male","American Indian or Alaska Native",6,"No",64,"No",14,10,14,38,14,9,14,37,22,45,"Yes"
"252",848,"female","Native Hawaiian or Other Pacific Islander",7,"Yes",52,"No",18,16,5,39,16,17,15,48,13,53,"No"
"253",26,"female","White",6,"No",53,"No",17,8,14,39,11,18,19,48,18,70,"No"
"254",963,"female","Native Hawaiian or Other Pacific Islander",6,"No",49,"No",17,14,8,39,13,18,16,47,38,63,"No"
"255",464,"female","White",6,"No",12,"Yes",17,9,6,32,10,14,18,42,18,97,"Yes"
"256",109,"male","Native Hawaiian or Other Pacific Islander",6,"Yes",74,"No",13,16,16,45,12,15,15,42,34,78,"No"
"257",777,"male","American Indian or Alaska Native",6,"No",46,"No",14,11,12,37,16,15,19,50,31,56,"No"
"258",988,"male","Asian",7,"Yes",38,"No",14,8,15,37,5,15,17,37,39,50,"No"
"259",931,"female","Native Hawaiian or Other Pacific Islander",7,"Yes",95,"Yes",17,17,11,45,17,15,16,48,41,77,"No"
"260",981,"female","Black or African American",8,"No",86,"No",13,18,6,37,12,11,5,28,42,93,"No"
"261",884,"female","Native Hawaiian or Other Pacific Islander",8,"No",75,"No",11,18,3,32,15,4,9,28,44,68,"No"
"262",459,"male","American Indian or Alaska Native",8,"Yes",50,"Yes",5,16,13,34,13,16,10,39,35,80,"No"
"263",585,"female","White",7,"Yes",62,"Yes",2,8,6,16,18,7,21,46,19,92,"Yes"
"264",582,"female","Native Hawaiian or Other Pacific Islander",6,"Yes",72,"Yes",14,9,16,39,10,6,18,34,22,49,"Yes"
"265",51,"female","American Indian or Alaska Native",6,"Yes",44,"No",7,7,20,34,17,18,10,45,34,68,"Yes"
"266",303,"female","Native Hawaiian or Other Pacific Islander",7,"No",33,"No",18,9,21,48,5,4,13,22,16,33,"Yes"
"267",317,"male","Asian",7,"No",69,"No",9,16,14,39,13,11,17,41,32,32,"No"
"268",434,"male","Black or African American",6,"Yes",80,"Yes",18,9,10,37,4,4,21,29,27,45,"Yes"
"269",140,"female","American Indian or Alaska Native",6,"No",24,"No",12,15,15,42,13,15,17,45,8,67,"No"
"270",522,"female","Black or African American",7,"No",97,"No",7,18,17,42,17,2,11,30,32,75,"Yes"
"271",446,"female","Native Hawaiian or Other Pacific Islander",8,"Yes",75,"No",16,13,3,32,16,16,10,42,31,42,"No"
"272",399,"male","Black or African American",7,"No",84,"No",1,10,16,27,11,15,21,47,7,83,"No"
"273",88,"female","Asian",7,"Yes",32,"No",10,10,16,36,10,15,9,34,38,64,"Yes"
"274",920,"female","Black or African American",8,"No",35,"No",13,9,15,37,8,9,13,30,2,79,"No"
"275",438,"male","Native Hawaiian or Other Pacific Islander",6,"No",92,"No",1,18,14,33,13,8,19,40,8,18,"Yes"
"276",18,"female","Asian",7,"No",60,"No",14,18,19,51,15,18,13,46,8,51,"Yes"
"277",865,"female","White",6,"Yes",87,"Yes",10,17,11,38,15,15,7,37,11,89,"Yes"
"278",613,"female","Asian",8,"No",53,"No",14,12,14,40,18,13,5,36,43,83,"No"
"279",589,"male","Native Hawaiian or Other Pacific Islander",8,"Yes",81,"No",9,4,11,24,6,10,18,34,42,81,"No"
"280",632,"female","Native Hawaiian or Other Pacific Islander",6,"No",52,"Yes",13,11,18,42,16,14,18,48,38,47,"Yes"
"281",778,"male","American Indian or Alaska Native",7,"Yes",84,"No",8,11,21,40,18,14,19,51,31,95,"No"
"282",433,"male","Native Hawaiian or Other Pacific Islander",6,"Yes",55,"Yes",18,13,20,51,17,6,16,39,13,67,"Yes"
"283",785,"male","American Indian or Alaska Native",7,"No",7,"Yes",11,18,12,41,13,7,20,40,16,15,"Yes"
"284",393,"female","Asian",7,"No",74,"Yes",8,15,21,44,16,6,13,35,20,32,"No"
"285",763,"female","Asian",8,"No",40,"Yes",15,3,11,29,5,12,17,34,50,89,"No"
"286",505,"male","White",7,"No",99,"Yes",14,18,3,35,13,12,20,45,10,72,"No"
"287",344,"male","Native Hawaiian or Other Pacific Islander",8,"No",98,"Yes",15,18,19,52,3,16,19,38,19,54,"Yes"
"288",68,"female","Asian",6,"No",89,"Yes",3,16,11,30,13,7,18,38,8,80,"No"
"289",392,"male","American Indian or Alaska Native",6,"Yes",55,"Yes",18,18,20,56,18,13,21,52,18,74,"No"
"290",615,"female","Asian",8,"No",59,"No",9,18,9,36,16,14,7,37,44,38,"Yes"
"291",774,"female","Native Hawaiian or Other Pacific Islander",8,"Yes",76,"Yes",18,9,18,45,13,7,21,41,16,71,"No"
"292",345,"female","American Indian or Alaska Native",8,"Yes",71,"No",15,7,19,41,18,8,3,29,47,77,"Yes"
"293",693,"female","Native Hawaiian or Other Pacific Islander",8,"No",73,"Yes",11,18,14,43,7,9,20,36,23,59,"No"
"294",493,"female","Asian",8,"Yes",57,"No",16,17,19,52,14,8,13,35,36,57,"No"
"295",543,"male","American Indian or Alaska Native",6,"No",84,"Yes",18,8,19,45,9,9,7,25,34,59,"Yes"
"296",318,"female","Asian",6,"Yes",85,"No",13,8,15,36,15,12,11,38,16,24,"Yes"
"297",437,"female","White",7,"No",76,"No",2,18,14,34,1,9,21,31,46,67,"Yes"
"298",266,"male","American Indian or Alaska Native",7,"Yes",63,"No",14,12,12,38,14,9,9,32,11,78,"Yes"
"299",616,"male","Native Hawaiian or Other Pacific Islander",7,"No",51,"Yes",15,17,9,41,16,12,3,31,8,70,"No"
"300",304,"female","Asian",8,"No",20,"No",18,4,8,30,18,15,12,45,34,82,"Yes"
"301",124,"female","Black or African American",7,"Yes",69,"Yes",8,14,6,28,11,18,19,48,11,78,"Yes"
"302",421,"male","American Indian or Alaska Native",6,"Yes",98,"No",3,11,19,33,9,18,18,45,11,98,"Yes"
"303",527,"male","Asian",6,"No",61,"Yes",18,16,18,52,18,17,10,45,11,42,"Yes"
"304",114,"female","Black or African American",8,"Yes",34,"No",15,13,15,43,7,14,8,29,38,11,"No"
"305",666,"male","White",6,"Yes",100,"No",8,10,3,21,9,18,19,46,4,84,"No"
"306",127,"male","White",8,"No",67,"Yes",6,13,20,39,6,16,9,31,27,43,"No"
"307",671,"male","American Indian or Alaska Native",6,"No",43,"Yes",17,13,7,37,14,6,7,27,26,72,"Yes"
"308",871,"male","Black or African American",7,"Yes",83,"Yes",15,16,7,38,14,16,10,40,17,42,"No"
"309",248,"male","Black or African American",8,"No",70,"Yes",10,9,3,22,8,15,18,41,1,72,"Yes"
"310",655,"male","Native Hawaiian or Other Pacific Islander",8,"No",57,"No",13,12,14,39,8,15,16,39,27,73,"Yes"
"311",420,"female","White",8,"Yes",43,"No",8,17,21,46,14,11,12,37,9,89,"No"
"312",997,"male","Native Hawaiian or Other Pacific Islander",7,"No",54,"Yes",14,15,14,43,12,15,21,48,48,54,"No"
"313",445,"female","Asian",6,"Yes",69,"No",13,18,13,44,18,12,15,45,50,83,"No"
"314",282,"male","Black or African American",6,"Yes",41,"No",10,14,9,33,13,5,7,25,43,46,"No"
"315",550,"female","American Indian or Alaska Native",8,"Yes",49,"Yes",10,15,21,46,1,11,18,30,20,97,"Yes"
"316",291,"male","Native Hawaiian or Other Pacific Islander",8,"Yes",66,"No",9,17,20,46,18,14,18,50,41,88,"Yes"
"317",749,"male","Native Hawaiian or Other Pacific Islander",6,"No",33,"Yes",18,11,6,35,9,15,17,41,11,60,"Yes"
"318",698,"female","White",6,"No",97,"No",14,16,18,48,14,12,21,47,45,67,"No"
"319",612,"male","Native Hawaiian or Other Pacific Islander",7,"No",86,"Yes",11,18,19,48,8,14,16,38,27,42,"Yes"
"320",676,"male","White",8,"Yes",32,"Yes",7,14,16,37,8,9,8,25,46,55,"Yes"
"321",125,"male","White",8,"Yes",78,"Yes",13,17,15,45,10,11,17,38,15,48,"Yes"
"322",854,"female","White",8,"No",100,"Yes",17,6,21,44,17,13,18,48,19,46,"Yes"
"323",53,"female","Black or African American",6,"No",10,"Yes",17,9,14,40,17,3,10,30,28,35,"No"
"324",593,"male","American Indian or Alaska Native",6,"Yes",84,"No",11,10,13,34,10,18,2,30,28,59,"No"
"325",363,"female","White",8,"No",87,"No",3,18,17,38,15,16,21,52,46,86,"No"
"326",379,"male","Asian",7,"No",37,"No",16,17,21,54,15,11,21,47,6,88,"Yes"
"327",850,"male","American Indian or Alaska Native",8,"Yes",65,"Yes",13,13,19,45,11,15,1,27,3,90,"Yes"
"328",720,"female","White",7,"Yes",91,"Yes",17,4,14,35,15,14,20,49,30,63,"No"
"329",22,"female","American Indian or Alaska Native",6,"Yes",84,"Yes",18,16,16,50,18,14,20,52,23,92,"No"
"330",863,"female","Native Hawaiian or Other Pacific Islander",7,"Yes",26,"Yes",15,9,12,36,16,6,19,41,8,86,"No"
"331",624,"female","Black or African American",8,"No",50,"Yes",14,4,12,30,9,9,15,33,28,32,"No"
"332",494,"male","Asian",8,"No",91,"No",15,13,12,40,3,17,20,40,42,90,"Yes"
"333",70,"male","White",7,"Yes",71,"No",18,9,19,46,4,17,19,40,4,95,"Yes"
"334",740,"male","White",7,"No",92,"Yes",7,17,12,36,7,11,21,39,35,64,"No"
"335",926,"female","Native Hawaiian or Other Pacific Islander",8,"No",100,"Yes",8,16,9,33,17,14,18,49,30,78,"Yes"
"336",713,"female","Native Hawaiian or Other Pacific Islander",6,"No",48,"No",12,12,18,42,7,5,14,26,10,7,"Yes"
"337",91,"male","White",8,"No",32,"Yes",13,14,18,45,16,1,9,26,43,97,"Yes"
"338",430,"female","Asian",6,"Yes",48,"Yes",15,18,19,52,17,6,16,39,46,14,"No"
"339",667,"male","White",6,"No",52,"Yes",18,16,13,47,18,18,21,57,13,46,"No"
"340",979,"male","American Indian or Alaska Native",7,"No",71,"Yes",10,13,13,36,13,8,21,42,43,65,"No"
"341",563,"male","Asian",8,"Yes",48,"Yes",16,14,14,44,9,18,10,37,39,64,"No"
"342",390,"male","American Indian or Alaska Native",8,"Yes",59,"No",18,17,19,54,13,14,16,43,26,96,"No"
"343",614,"female","American Indian or Alaska Native",7,"No",62,"Yes",15,6,20,41,10,16,21,47,32,100,"Yes"
"344",946,"female","American Indian or Alaska Native",6,"Yes",78,"No",5,12,18,35,5,8,16,29,1,88,"Yes"
"345",447,"male","Native Hawaiian or Other Pacific Islander",6,"No",87,"No",10,13,16,39,16,17,21,54,31,90,"No"
"346",198,"male","White",6,"Yes",52,"No",11,6,17,34,12,14,21,47,38,67,"Yes"
"347",183,"female","Native Hawaiian or Other Pacific Islander",8,"No",26,"No",14,3,18,35,10,14,17,41,50,23,"Yes"
"348",285,"female","American Indian or Alaska Native",6,"No",93,"No",16,16,16,48,15,11,14,40,3,88,"No"
"349",548,"male","Black or African American",7,"No",89,"Yes",8,13,3,24,16,17,21,54,46,95,"No"
"350",629,"female","Black or African American",6,"No",88,"No",9,9,12,30,8,5,16,29,19,79,"No"
"351",886,"male","Asian",7,"Yes",63,"No",17,10,14,41,13,15,5,33,9,54,"No"
"352",513,"female","American Indian or Alaska Native",8,"No",59,"Yes",16,18,6,40,11,18,18,47,33,24,"Yes"
"353",973,"male","Black or African American",6,"No",46,"Yes",8,17,3,28,17,17,15,49,41,68,"No"
"354",414,"male","Black or African American",7,"No",64,"Yes",18,10,13,41,15,16,17,48,38,89,"No"
"355",410,"male","Asian",8,"No",48,"No",16,7,20,43,18,10,16,44,21,90,"Yes"
"356",800,"female","Black or African American",6,"Yes",23,"Yes",12,14,18,44,9,9,19,37,43,34,"Yes"
"357",773,"male","American Indian or Alaska Native",7,"Yes",91,"Yes",18,14,13,45,17,12,21,50,18,97,"No"
"358",186,"female","Asian",8,"Yes",94,"Yes",10,17,13,40,14,12,6,32,37,54,"No"
"359",84,"female","White",7,"Yes",66,"No",13,17,18,48,18,12,19,49,22,74,"Yes"
"360",573,"female","Asian",8,"No",84,"No",13,18,12,43,12,9,14,35,3,57,"Yes"
"361",841,"female","White",7,"No",50,"No",17,18,6,41,17,12,20,49,48,72,"Yes"
"362",933,"female","White",8,"No",51,"No",12,12,9,33,11,13,19,43,20,46,"Yes"
"363",574,"male","American Indian or Alaska Native",6,"No",82,"Yes",9,16,4,29,15,14,11,40,41,70,"No"
"364",742,"male","Black or African American",8,"Yes",99,"No",17,9,4,30,7,15,17,39,35,24,"No"
"365",746,"male","Asian",7,"Yes",57,"Yes",5,18,14,37,18,8,19,45,5,65,"No"
"366",782,"female","American Indian or Alaska Native",6,"Yes",35,"No",14,16,10,40,18,14,19,51,28,52,"Yes"
"367",19,"male","American Indian or Alaska Native",6,"Yes",63,"Yes",14,17,20,51,8,9,15,32,36,99,"Yes"
"368",937,"female","Black or African American",8,"Yes",90,"No",13,15,11,39,12,18,17,47,46,55,"No"
"369",833,"female","American Indian or Alaska Native",6,"Yes",95,"No",11,11,12,34,14,17,13,44,17,82,"No"
"370",893,"female","American Indian or Alaska Native",6,"No",67,"No",18,17,17,52,8,18,21,47,50,74,"Yes"
"371",644,"male","Asian",8,"No",22,"Yes",17,7,16,40,8,8,19,35,4,64,"No"
"372",31,"male","Asian",7,"Yes",50,"Yes",15,18,14,47,15,13,21,49,12,75,"Yes"
"373",567,"female","American Indian or Alaska Native",6,"No",97,"No",18,13,13,44,15,18,1,34,1,49,"No"
"374",405,"male","Black or African American",6,"Yes",98,"No",16,18,18,52,9,13,18,40,46,48,"No"
"375",451,"male","Asian",8,"Yes",42,"No",8,9,6,23,16,7,9,32,41,57,"Yes"
"376",517,"female","Native Hawaiian or Other Pacific Islander",8,"Yes",99,"No",15,17,15,47,18,6,10,34,13,85,"Yes"
"377",971,"male","Asian",7,"Yes",66,"No",3,13,16,32,16,18,16,50,17,54,"Yes"
"378",103,"male","Native Hawaiian or Other Pacific Islander",6,"No",31,"Yes",8,16,21,45,8,16,14,38,47,87,"No"
"379",128,"female","White",6,"No",68,"Yes",18,3,7,28,13,18,14,45,44,95,"Yes"
"380",350,"male","White",7,"No",58,"Yes",17,17,9,43,12,17,21,50,45,66,"Yes"
"381",394,"female","White",7,"Yes",67,"No",18,10,7,35,16,12,21,49,26,51,"No"
"382",233,"female","Asian",6,"Yes",67,"No",14,15,9,38,18,7,12,37,45,89,"No"
"383",98,"male","Native Hawaiian or Other Pacific Islander",8,"No",84,"No",17,9,17,43,17,15,13,45,12,51,"Yes"
"384",37,"male","Native Hawaiian or Other Pacific Islander",8,"Yes",83,"Yes",12,13,21,46,16,16,17,49,30,94,"No"
"385",86,"female","Asian",7,"Yes",12,"Yes",18,15,10,43,8,14,11,33,23,98,"Yes"
"386",239,"male","White",8,"No",56,"No",16,14,2,32,13,13,13,39,43,34,"Yes"
"387",66,"male","Black or African American",6,"No",47,"Yes",16,16,16,48,5,13,11,29,47,28,"No"
"388",986,"male","Asian",6,"Yes",32,"Yes",13,8,11,32,13,12,17,42,22,73,"Yes"
"389",25,"male","American Indian or Alaska Native",7,"Yes",38,"Yes",14,16,16,46,7,15,19,41,50,63,"Yes"
"390",316,"male","White",6,"No",49,"Yes",17,9,19,45,16,15,15,46,35,23,"No"
"391",58,"male","Native Hawaiian or Other Pacific Islander",8,"No",42,"No",3,17,20,40,13,10,12,35,22,47,"No"
"392",162,"male","White",6,"Yes",77,"No",11,13,21,45,9,9,10,28,26,95,"No"
"393",923,"male","Asian",8,"No",21,"Yes",16,17,11,44,7,12,19,38,42,41,"No"
"394",806,"male","White",6,"Yes",95,"Yes",18,14,10,42,9,11,13,33,21,39,"Yes"
"395",497,"male","American Indian or Alaska Native",8,"No",20,"No",17,18,12,47,15,16,11,42,10,78,"Yes"
"396",415,"male","Native Hawaiian or Other Pacific Islander",8,"Yes",93,"Yes",9,17,9,35,15,4,21,40,27,56,"No"
"397",715,"female","American Indian or Alaska Native",7,"No",76,"No",18,10,12,40,15,17,15,47,18,95,"Yes"
"398",77,"male","Black or African American",6,"Yes",65,"No",11,17,16,44,17,7,12,36,14,11,"Yes"
"399",621,"female","Native Hawaiian or Other Pacific Islander",8,"Yes",37,"No",14,12,10,36,13,17,13,43,28,94,"No"
"400",790,"male","Black or African American",6,"No",98,"No",17,8,17,42,17,16,8,41,11,94,"No"
"401",30,"male","American Indian or Alaska Native",6,"No",89,"No",15,10,18,43,9,10,15,34,28,76,"No"
"402",664,"male","Asian",6,"No",96,"No",9,3,15,27,5,12,16,33,24,50,"No"
"403",450,"male","White",8,"Yes",100,"No",10,12,20,42,9,18,13,40,11,61,"No"
"404",64,"male","Asian",7,"No",73,"No",17,18,8,43,12,9,17,38,25,82,"No"
"405",315,"female","Asian",6,"No",55,"No",16,14,16,46,14,7,13,34,26,27,"Yes"
"406",670,"female","White",6,"No",44,"No",17,18,11,46,18,14,16,48,1,72,"Yes"
"407",312,"male","White",6,"No",36,"Yes",5,8,8,21,15,2,20,37,29,47,"No"
"408",196,"male","American Indian or Alaska Native",7,"No",87,"Yes",16,5,8,29,9,12,13,34,44,46,"Yes"
"409",220,"male","Native Hawaiian or Other Pacific Islander",8,"Yes",83,"Yes",11,5,20,36,7,12,16,35,36,55,"Yes"
"410",904,"male","American Indian or Alaska Native",6,"No",58,"Yes",17,5,21,43,9,16,10,35,43,38,"No"
"411",642,"male","Asian",8,"Yes",70,"No",16,1,10,27,16,17,17,50,30,71,"No"
"412",358,"female","White",7,"Yes",19,"No",7,14,10,31,15,18,18,51,3,95,"Yes"
"413",428,"male","Native Hawaiian or Other Pacific Islander",6,"No",100,"Yes",15,9,10,34,17,15,13,45,33,95,"Yes"
"414",268,"female","Native Hawaiian or Other Pacific Islander",7,"Yes",71,"Yes",9,15,18,42,12,18,16,46,33,29,"Yes"
"415",313,"male","American Indian or Alaska Native",7,"Yes",68,"Yes",12,17,12,41,15,13,1,29,25,33,"Yes"
"416",178,"male","Native Hawaiian or Other Pacific Islander",6,"Yes",84,"No",13,7,14,34,12,17,18,47,7,77,"No"
"417",835,"female","White",8,"No",81,"No",15,13,17,45,11,10,15,36,4,64,"No"
"418",989,"female","Asian",8,"No",90,"No",18,10,4,32,14,14,18,46,13,62,"No"
"419",647,"male","Black or African American",6,"Yes",45,"Yes",12,1,21,34,7,9,10,26,9,75,"No"
"420",512,"male","Asian",6,"No",96,"Yes",8,10,21,39,11,14,11,36,10,73,"No"
"421",444,"female","Native Hawaiian or Other Pacific Islander",8,"Yes",37,"Yes",11,16,18,45,18,8,11,37,4,94,"Yes"
"422",678,"male","White",8,"Yes",88,"Yes",16,12,17,45,12,16,20,48,46,90,"No"
"423",639,"female","Black or African American",6,"No",95,"No",12,13,10,35,18,9,20,47,1,34,"Yes"
"424",894,"female","Native Hawaiian or Other Pacific Islander",8,"Yes",96,"Yes",17,10,18,45,17,11,14,42,45,66,"No"
"425",945,"male","Native Hawaiian or Other Pacific Islander",7,"Yes",99,"No",8,12,21,41,13,16,20,49,45,94,"No"
"426",492,"male","Native Hawaiian or Other Pacific Islander",8,"No",78,"Yes",12,7,21,40,11,1,10,22,15,12,"Yes"
"427",830,"male","White",8,"No",95,"Yes",3,8,16,27,14,15,17,46,13,69,"Yes"
"428",348,"male","American Indian or Alaska Native",6,"No",44,"Yes",14,18,12,44,16,6,16,38,13,95,"No"
"429",191,"female","Native Hawaiian or Other Pacific Islander",8,"Yes",54,"Yes",18,5,14,37,7,16,13,36,8,84,"No"
"430",412,"female","Asian",8,"Yes",81,"No",10,11,8,29,15,15,15,45,3,66,"Yes"
"431",991,"female","White",8,"No",75,"No",17,12,19,48,11,14,20,45,10,32,"No"
"432",82,"male","White",7,"No",25,"No",7,17,20,44,12,9,19,40,23,64,"Yes"
"433",419,"female","Native Hawaiian or Other Pacific Islander",7,"Yes",80,"Yes",3,2,12,17,18,17,8,43,3,97,"Yes"
"434",734,"female","Black or African American",6,"No",57,"No",6,13,8,27,15,18,20,53,40,77,"No"
"435",797,"male","Black or African American",6,"No",62,"Yes",16,17,18,51,8,2,18,28,7,58,"No"
"436",94,"male","Black or African American",6,"Yes",34,"No",16,11,20,47,10,4,10,24,11,98,"Yes"
"437",837,"male","White",8,"No",56,"No",17,11,19,47,7,9,16,32,1,93,"Yes"
"438",194,"female","White",7,"Yes",52,"No",2,8,12,22,17,17,20,54,17,56,"Yes"
"439",458,"female","Asian",7,"Yes",100,"Yes",7,15,18,40,17,17,8,42,16,89,"Yes"
"440",633,"female","White",7,"No",57,"No",11,15,9,35,13,16,9,38,1,94,"Yes"
"441",877,"female","Native Hawaiian or Other Pacific Islander",8,"No",83,"No",14,5,9,28,9,11,21,41,21,96,"No"
"442",227,"female","Native Hawaiian or Other Pacific Islander",7,"No",92,"Yes",12,15,19,46,7,6,19,32,25,87,"No"
"443",395,"female","White",6,"Yes",88,"No",7,4,17,28,6,17,19,42,48,77,"Yes"
"444",537,"male","Black or African American",8,"Yes",56,"No",10,6,19,35,11,16,19,46,43,56,"No"
"445",880,"male","American Indian or Alaska Native",6,"Yes",55,"Yes",8,14,17,39,15,12,14,41,13,84,"Yes"
"446",208,"female","White",7,"No",61,"No",2,18,20,40,11,12,15,38,12,52,"Yes"
"447",386,"female","American Indian or Alaska Native",6,"No",35,"No",18,18,13,49,17,18,2,37,27,74,"No"
"448",786,"male","Native Hawaiian or Other Pacific Islander",8,"Yes",78,"Yes",5,17,17,39,17,10,19,46,23,94,"No"
"449",704,"female","Black or African American",7,"No",64,"No",13,10,16,39,6,13,12,31,31,88,"Yes"
"450",17,"female","Black or African American",7,"No",34,"No",15,8,21,44,5,16,10,31,18,81,"Yes"
"451",519,"male","Black or African American",6,"No",58,"No",12,15,6,33,5,17,5,27,45,4,"Yes"
"452",148,"female","American Indian or Alaska Native",6,"Yes",77,"No",3,5,19,27,13,10,9,32,13,79,"Yes"
"453",761,"female","Native Hawaiian or Other Pacific Islander",7,"No",98,"Yes",17,16,21,54,14,15,20,49,37,89,"Yes"
"454",235,"female","Native Hawaiian or Other Pacific Islander",6,"No",96,"Yes",12,11,21,44,6,7,8,21,14,63,"No"
"455",637,"male","Native Hawaiian or Other Pacific Islander",6,"Yes",48,"Yes",14,16,17,47,17,14,21,52,37,84,"No"
"456",858,"female","White",8,"Yes",89,"Yes",16,8,11,35,18,8,14,40,10,47,"No"
"457",739,"male","Asian",8,"No",29,"Yes",15,4,21,40,14,11,15,40,50,42,"No"
"458",452,"female","White",6,"No",62,"No",15,9,21,45,18,18,10,46,9,96,"No"
"459",640,"female","White",6,"No",81,"Yes",11,18,7,36,18,13,17,48,24,43,"No"
"460",426,"male","Native Hawaiian or Other Pacific Islander",6,"No",90,"Yes",16,9,16,41,10,4,4,18,11,45,"No"
"461",769,"female","Asian",7,"Yes",71,"Yes",16,9,13,38,12,17,10,39,15,92,"Yes"
"462",726,"female","Black or African American",6,"No",92,"Yes",4,14,9,27,9,7,8,24,32,25,"No"
"463",154,"male","Asian",7,"No",46,"Yes",13,4,20,37,11,17,11,39,19,79,"Yes"
"464",887,"female","White",7,"No",90,"Yes",16,10,12,38,3,18,21,42,35,24,"No"
"465",596,"male","Black or African American",7,"Yes",67,"No",14,16,14,44,16,11,14,41,31,54,"Yes"
"466",250,"female","American Indian or Alaska Native",7,"Yes",11,"No",17,16,10,43,18,13,19,50,18,48,"No"
"467",356,"female","Asian",8,"No",88,"No",13,18,16,47,17,13,9,39,21,99,"No"
"468",554,"male","American Indian or Alaska Native",8,"Yes",87,"No",10,10,14,34,8,10,16,34,42,99,"Yes"
"469",531,"female","Asian",7,"No",48,"Yes",13,15,21,49,13,7,13,33,7,55,"No"
"470",234,"male","Black or African American",6,"No",100,"Yes",8,11,18,37,8,16,17,41,41,31,"No"
"471",906,"male","American Indian or Alaska Native",8,"Yes",87,"Yes",15,15,15,45,16,9,19,44,27,76,"No"
"472",682,"male","Native Hawaiian or Other Pacific Islander",7,"No",75,"Yes",18,10,18,46,18,14,11,43,17,53,"No"
"473",247,"male","American Indian or Alaska Native",6,"Yes",56,"No",15,16,5,36,13,12,7,32,42,48,"Yes"
"474",847,"male","Black or African American",7,"No",97,"Yes",15,16,15,46,10,16,17,43,32,72,"No"
"475",209,"female","White",7,"No",94,"No",13,12,13,38,10,14,7,31,47,81,"No"
"476",541,"male","White",7,"Yes",36,"No",13,16,21,50,10,13,13,36,21,66,"No"
"477",932,"male","American Indian or Alaska Native",6,"No",41,"No",7,1,20,28,18,17,18,53,13,75,"Yes"
"478",314,"male","Asian",8,"No",85,"No",14,16,19,49,12,18,20,50,10,87,"Yes"
"479",1000,"male","American Indian or Alaska Native",7,"Yes",80,"Yes",16,6,14,36,14,7,3,24,33,45,"No"
"480",112,"female","White",6,"No",29,"Yes",9,9,18,36,18,14,19,51,31,46,"No"
"481",298,"male","Asian",6,"Yes",94,"Yes",10,4,20,34,6,18,17,41,35,74,"No"
"482",866,"male","American Indian or Alaska Native",7,"No",80,"Yes",17,10,7,34,8,4,19,31,42,83,"No"
"483",970,"female","White",8,"No",89,"No",15,12,14,41,9,17,19,45,36,80,"Yes"
"484",12,"male","Black or African American",8,"No",75,"Yes",15,10,17,42,13,1,7,21,20,75,"Yes"
"485",272,"male","Black or African American",7,"Yes",48,"No",9,12,20,41,16,17,21,54,16,54,"No"
"486",912,"female","White",6,"No",55,"Yes",15,14,17,46,15,14,8,37,14,61,"No"
"487",8,"female","White",7,"Yes",66,"No",3,17,18,38,16,10,19,45,1,95,"No"
"488",353,"male","American Indian or Alaska Native",6,"Yes",40,"Yes",14,4,16,34,10,13,15,38,5,28,"No"
"489",617,"male","Asian",6,"Yes",100,"Yes",18,11,17,46,4,15,14,33,34,85,"Yes"
"490",108,"female","American Indian or Alaska Native",8,"No",87,"Yes",18,17,15,50,1,18,20,39,49,92,"No"
"491",67,"male","White",6,"Yes",40,"Yes",18,17,17,52,18,16,21,55,40,80,"Yes"
"492",199,"male","American Indian or Alaska Native",7,"No",99,"Yes",8,18,15,41,15,17,7,39,13,89,"No"
"493",881,"female","Native Hawaiian or Other Pacific Islander",6,"Yes",44,"No",12,11,17,40,11,14,12,37,4,68,"No"
"494",876,"female","White",8,"Yes",61,"Yes",18,15,10,43,14,5,15,34,25,60,"Yes"
"495",249,"male","American Indian or Alaska Native",8,"No",90,"No",15,13,20,48,17,15,17,49,35,46,"No"
"496",403,"female","Asian",7,"No",59,"Yes",3,12,17,32,5,18,20,43,24,82,"Yes"
"497",74,"male","Black or African American",7,"No",60,"No",13,7,13,33,13,9,21,43,18,89,"No"
"498",766,"male","Asian",7,"Yes",85,"No",13,11,10,34,16,18,19,53,22,56,"No"
"499",336,"male","White",6,"Yes",96,"No",15,9,21,45,17,9,14,40,35,61,"No"
"500",491,"male","American Indian or Alaska Native",6,"Yes",70,"Yes",13,3,13,29,6,18,19,43,34,21,"No"
"501",859,"male","Black or African American",7,"No",54,"No",10,11,17,38,3,14,16,33,39,95,"Yes"
"502",529,"female","American Indian or Alaska Native",8,"No",88,"Yes",14,16,15,45,18,17,18,53,42,62,"Yes"
"503",914,"male","American Indian or Alaska Native",8,"No",79,"No",15,10,8,33,16,14,21,51,7,90,"No"
"504",897,"female","Asian",8,"Yes",100,"Yes",17,7,10,34,7,17,21,45,18,77,"No"
"505",204,"male","American Indian or Alaska Native",6,"No",57,"No",11,14,20,45,14,18,19,51,35,95,"Yes"
"506",901,"female","American Indian or Alaska Native",6,"No",84,"Yes",14,6,17,37,12,18,19,49,29,61,"No"
"507",170,"male","Native Hawaiian or Other Pacific Islander",7,"No",85,"No",13,7,15,35,8,18,7,33,14,47,"Yes"
"508",500,"female","Black or African American",6,"Yes",24,"No",12,17,20,49,12,9,20,41,33,28,"No"
"509",788,"female","Native Hawaiian or Other Pacific Islander",7,"No",75,"Yes",5,16,21,42,15,12,21,48,23,47,"Yes"
"510",171,"male","Asian",8,"No",28,"No",18,15,16,49,11,9,5,25,15,97,"No"
"511",649,"male","American Indian or Alaska Native",7,"No",95,"Yes",12,15,17,44,16,14,14,44,7,68,"Yes"
"512",93,"female","Native Hawaiian or Other Pacific Islander",6,"No",64,"Yes",7,12,10,29,16,7,9,32,13,60,"No"
"513",207,"male","Native Hawaiian or Other Pacific Islander",7,"Yes",96,"Yes",12,11,13,36,15,6,2,23,4,99,"No"
"514",96,"female","White",8,"No",98,"Yes",12,9,17,38,17,4,13,34,11,92,"Yes"
"515",571,"male","Asian",7,"Yes",83,"Yes",18,17,12,47,15,17,14,46,25,97,"Yes"
"516",416,"male","White",6,"No",58,"No",4,12,13,29,15,2,13,30,46,97,"Yes"
"517",725,"male","White",7,"No",55,"No",14,4,17,35,9,15,14,38,16,67,"No"
"518",156,"male","White",7,"No",56,"No",13,14,19,46,8,16,16,40,36,21,"No"
"519",845,"male","Native Hawaiian or Other Pacific Islander",8,"Yes",45,"No",18,11,16,45,18,17,5,40,35,57,"Yes"
"520",597,"male","Black or African American",8,"No",69,"No",7,14,10,31,17,7,19,43,14,65,"No"
"521",264,"female","Native Hawaiian or Other Pacific Islander",7,"No",67,"No",13,14,8,35,18,4,18,40,33,95,"Yes"
"522",743,"male","White",8,"Yes",67,"No",10,15,18,43,18,11,14,43,39,96,"No"
"523",853,"male","Black or African American",6,"No",82,"Yes",17,17,20,54,15,13,12,40,30,69,"Yes"
"524",808,"male","White",8,"Yes",68,"No",10,6,16,32,3,12,9,24,7,68,"Yes"
"525",436,"male","Native Hawaiian or Other Pacific Islander",6,"No",33,"No",15,15,6,36,12,7,18,37,7,43,"Yes"
"526",288,"male","Native Hawaiian or Other Pacific Islander",8,"Yes",75,"No",14,13,6,33,16,16,21,53,25,81,"Yes"
"527",804,"male","American Indian or Alaska Native",8,"No",72,"No",12,8,6,26,6,8,19,33,37,100,"Yes"
"528",885,"male","Black or African American",7,"No",80,"Yes",11,18,18,47,13,9,20,42,19,76,"Yes"
"529",631,"female","White",6,"Yes",42,"Yes",18,16,2,36,11,8,17,36,34,53,"Yes"
"530",159,"male","Native Hawaiian or Other Pacific Islander",7,"Yes",96,"Yes",16,5,8,29,14,13,17,44,25,96,"No"
"531",192,"female","Black or African American",7,"Yes",31,"Yes",13,17,21,51,17,7,20,44,41,91,"Yes"
"532",701,"female","White",6,"Yes",85,"No",9,17,18,44,5,10,11,26,34,48,"No"
"533",943,"female","Black or African American",6,"Yes",92,"No",14,9,21,44,10,14,15,39,46,49,"Yes"
"534",391,"female","Asian",8,"No",91,"No",14,17,21,52,14,13,8,35,6,62,"No"
"535",259,"male","White",7,"No",92,"Yes",5,12,12,29,14,17,17,48,32,98,"No"
"536",827,"female","Black or African American",8,"Yes",92,"Yes",11,9,19,39,14,17,11,42,26,80,"No"
"537",967,"female","White",8,"No",94,"Yes",9,16,9,34,14,13,11,38,38,65,"Yes"
"538",507,"male","Asian",8,"No",77,"No",14,11,20,45,11,17,21,49,18,73,"No"
"539",482,"female","White",8,"No",94,"No",16,17,12,45,11,6,19,36,15,95,"No"
"540",274,"female","White",8,"Yes",100,"No",16,18,13,47,17,12,15,44,18,100,"No"
"541",867,"female","American Indian or Alaska Native",6,"Yes",88,"Yes",8,17,17,42,17,14,13,44,35,93,"No"
"542",369,"male","Native Hawaiian or Other Pacific Islander",8,"No",38,"Yes",17,15,8,40,17,18,19,54,26,23,"Yes"
"543",540,"female","Black or African American",6,"Yes",51,"Yes",7,15,9,31,14,11,14,39,47,20,"Yes"
"544",448,"male","Asian",7,"No",97,"Yes",18,16,13,47,17,15,21,53,11,32,"No"
"545",510,"female","Native Hawaiian or Other Pacific Islander",7,"Yes",100,"No",17,7,21,45,6,13,1,20,44,75,"Yes"
"546",566,"female","Asian",7,"Yes",65,"Yes",12,17,18,47,18,11,21,50,38,66,"Yes"
"547",934,"male","White",6,"No",94,"Yes",14,11,18,43,14,12,10,36,18,63,"No"
"548",533,"female","White",6,"Yes",99,"No",16,15,19,50,8,7,15,30,9,70,"Yes"
"549",123,"female","Black or African American",6,"No",71,"No",11,7,13,31,15,16,19,50,13,82,"Yes"
"550",768,"male","White",6,"Yes",45,"No",12,18,20,50,15,17,8,40,31,97,"No"
"551",925,"male","Asian",7,"Yes",45,"Yes",3,9,19,31,18,10,21,49,13,86,"No"
"552",177,"male","American Indian or Alaska Native",6,"No",32,"No",11,17,15,43,18,10,9,37,30,93,"No"
"553",695,"female","American Indian or Alaska Native",7,"No",57,"No",11,12,18,41,18,18,14,50,24,38,"No"
"554",712,"male","Asian",8,"Yes",25,"Yes",12,16,19,47,2,18,17,37,26,76,"Yes"
"555",744,"male","Asian",6,"No",36,"Yes",14,15,21,50,18,5,20,43,40,50,"No"
"556",601,"male","American Indian or Alaska Native",8,"Yes",65,"Yes",17,16,4,37,8,12,15,35,1,74,"No"
"557",295,"female","American Indian or Alaska Native",6,"No",69,"No",4,9,11,24,17,9,18,44,21,65,"No"
"558",913,"male","Black or African American",7,"No",97,"Yes",16,13,21,50,16,11,14,41,9,72,"Yes"
"559",210,"female","Black or African American",8,"No",87,"Yes",16,11,13,40,14,7,13,34,17,41,"Yes"
"560",301,"female","Black or African American",8,"Yes",76,"No",13,17,12,42,9,18,17,44,20,97,"Yes"
"561",710,"female","Asian",8,"Yes",83,"Yes",9,11,20,40,11,10,18,39,29,100,"Yes"
"562",780,"female","Black or African American",8,"No",75,"Yes",17,18,12,47,15,14,17,46,40,62,"Yes"
"563",558,"male","Native Hawaiian or Other Pacific Islander",7,"Yes",87,"Yes",17,14,21,52,17,13,6,36,27,99,"Yes"
"564",201,"female","White",8,"Yes",96,"No",14,7,21,42,9,8,15,32,9,26,"Yes"
"565",383,"male","Black or African American",6,"Yes",92,"No",6,10,21,37,4,1,18,23,6,59,"No"
"566",488,"female","American Indian or Alaska Native",8,"Yes",64,"Yes",8,12,15,35,16,16,18,50,29,50,"Yes"
"567",460,"male","Native Hawaiian or Other Pacific Islander",7,"Yes",41,"No",17,13,18,48,15,13,19,47,37,88,"No"
"568",429,"female","American Indian or Alaska Native",6,"Yes",24,"No",17,9,17,43,8,13,21,42,36,69,"Yes"
"569",138,"female","Native Hawaiian or Other Pacific Islander",8,"Yes",62,"No",15,17,12,44,15,16,16,47,18,40,"Yes"
"570",179,"male","White",7,"Yes",95,"No",9,16,13,38,18,17,19,54,34,89,"Yes"
"571",300,"female","Asian",7,"No",63,"No",15,16,21,52,13,10,14,37,19,94,"No"
"572",714,"female","Asian",6,"Yes",58,"Yes",14,10,12,36,15,17,11,43,27,35,"No"
"573",813,"female","Native Hawaiian or Other Pacific Islander",8,"No",85,"Yes",15,15,6,36,18,16,19,53,40,87,"Yes"
"574",190,"female","American Indian or Alaska Native",7,"Yes",83,"Yes",3,17,18,38,17,17,11,45,41,93,"No"
"575",924,"female","Asian",7,"Yes",79,"No",17,11,13,41,11,14,17,42,46,99,"No"
"576",56,"male","Black or African American",8,"Yes",32,"No",5,16,17,38,4,1,2,7,16,40,"Yes"
"577",555,"female","Asian",8,"Yes",69,"No",12,7,16,35,8,13,10,31,3,98,"Yes"
"578",376,"male","American Indian or Alaska Native",6,"Yes",20,"No",14,18,21,53,16,14,17,47,9,37,"No"
"579",15,"male","Asian",8,"Yes",99,"Yes",10,10,19,39,8,12,14,34,37,46,"Yes"
"580",506,"male","Black or African American",7,"No",90,"No",13,7,2,22,13,8,6,27,30,74,"Yes"
"581",38,"male","Native Hawaiian or Other Pacific Islander",7,"Yes",76,"No",12,10,12,34,7,17,19,43,4,48,"No"
"582",807,"female","American Indian or Alaska Native",6,"No",99,"Yes",15,13,13,41,16,7,19,42,33,65,"No"
"583",242,"male","Native Hawaiian or Other Pacific Islander",8,"No",29,"Yes",18,17,15,50,7,16,21,44,10,88,"Yes"
"584",564,"female","Black or African American",6,"No",71,"No",12,17,9,38,8,10,12,30,27,88,"No"
"585",958,"male","White",7,"Yes",52,"Yes",12,18,17,47,15,16,4,35,44,98,"Yes"
"586",39,"female","White",6,"Yes",96,"No",16,11,5,32,17,14,15,46,30,91,"No"
"587",172,"male","White",7,"Yes",68,"Yes",16,18,12,46,14,7,10,31,1,92,"No"
"588",672,"female","White",6,"No",42,"No",4,17,14,35,15,4,17,36,41,45,"Yes"
"589",132,"female","Asian",8,"No",75,"Yes",17,8,16,41,5,16,20,41,50,76,"Yes"
"590",980,"female","American Indian or Alaska Native",8,"No",35,"Yes",16,7,11,34,5,16,19,40,7,49,"No"
"591",539,"female","White",8,"No",85,"No",17,12,20,49,13,4,9,26,49,49,"No"
"592",290,"male","Asian",6,"No",63,"No",17,16,11,44,18,5,19,42,32,54,"No"
"593",340,"male","Black or African American",8,"No",94,"No",15,13,18,46,13,8,21,42,30,59,"Yes"
"594",129,"female","Asian",8,"No",99,"Yes",9,5,1,15,8,16,17,41,1,91,"No"
"595",256,"female","Native Hawaiian or Other Pacific Islander",6,"Yes",21,"Yes",15,18,18,51,16,15,21,52,34,24,"No"
"596",756,"female","American Indian or Alaska Native",8,"Yes",97,"Yes",10,15,20,45,13,17,19,49,36,80,"No"
"597",34,"female","White",8,"Yes",90,"No",1,17,12,30,11,13,7,31,12,63,"No"
"598",189,"male","Native Hawaiian or Other Pacific Islander",6,"Yes",76,"No",11,17,15,43,17,14,18,49,25,85,"Yes"
"599",654,"female","American Indian or Alaska Native",7,"Yes",96,"Yes",18,17,12,47,18,18,19,55,11,75,"Yes"
"600",417,"female","American Indian or Alaska Native",6,"Yes",51,"Yes",12,13,5,30,16,10,21,47,8,83,"Yes"
"601",993,"male","Native Hawaiian or Other Pacific Islander",8,"No",73,"Yes",4,16,18,38,14,16,21,51,34,94,"No"
"602",959,"male","Native Hawaiian or Other Pacific Islander",7,"No",73,"Yes",9,16,12,37,18,3,18,39,32,54,"No"
"603",599,"male","American Indian or Alaska Native",7,"Yes",62,"Yes",6,18,15,39,14,1,20,35,28,23,"Yes"
"604",878,"female","White",8,"No",92,"No",6,6,11,23,11,11,18,40,38,89,"Yes"
"605",449,"female","White",6,"Yes",85,"No",13,7,17,37,1,18,16,35,12,54,"No"
"606",122,"female","White",8,"No",43,"No",15,15,21,51,11,17,20,48,8,37,"No"
"607",289,"male","Asian",7,"Yes",37,"Yes",7,15,17,39,13,18,19,50,38,75,"Yes"
"608",890,"male","Asian",8,"No",19,"No",16,16,6,38,13,7,21,41,3,91,"Yes"
"609",523,"male","White",8,"Yes",100,"Yes",1,12,6,19,14,15,19,48,11,97,"No"
"610",665,"female","Asian",8,"No",85,"No",9,17,21,47,15,15,12,42,35,27,"Yes"
"611",975,"female","Black or African American",6,"No",78,"No",11,12,18,41,11,14,11,36,41,60,"Yes"
"612",240,"male","White",6,"No",76,"Yes",17,13,6,36,14,4,18,36,34,59,"No"
"613",466,"male","Asian",6,"Yes",57,"No",10,9,9,28,12,8,10,30,43,85,"Yes"
"614",592,"male","Native Hawaiian or Other Pacific Islander",7,"Yes",93,"No",1,10,21,32,15,9,19,43,40,68,"No"
"615",157,"male","Asian",8,"No",96,"No",13,17,11,41,2,18,9,29,39,62,"No"
"616",63,"male","American Indian or Alaska Native",6,"Yes",22,"No",15,11,21,47,11,18,10,39,22,83,"Yes"
"617",275,"female","Asian",8,"No",73,"No",4,15,18,37,12,15,13,40,20,47,"Yes"
"618",147,"female","Native Hawaiian or Other Pacific Islander",8,"No",86,"No",18,14,10,42,15,17,4,36,27,51,"Yes"
"619",568,"male","Asian",7,"Yes",84,"Yes",13,18,1,32,8,16,14,38,27,83,"Yes"
"620",87,"female","Asian",7,"Yes",76,"Yes",5,2,9,16,12,15,15,42,20,86,"No"
"621",802,"female","Native Hawaiian or Other Pacific Islander",6,"Yes",35,"Yes",16,16,17,49,15,10,19,44,23,92,"No"
"622",600,"male","Asian",8,"No",68,"Yes",18,11,13,42,13,13,14,40,11,61,"No"
"623",842,"female","White",7,"No",91,"Yes",16,8,11,35,17,13,15,45,7,66,"No"
"624",230,"male","Asian",7,"No",97,"Yes",7,15,5,27,8,6,18,32,26,88,"Yes"
"625",355,"female","Asian",6,"Yes",71,"Yes",15,18,17,50,16,17,2,35,17,31,"No"
"626",729,"female","White",6,"No",83,"No",8,16,18,42,16,12,10,38,6,79,"Yes"
"627",775,"male","Asian",6,"Yes",47,"Yes",11,8,19,38,12,10,21,43,36,75,"No"
"628",14,"female","White",6,"Yes",76,"Yes",2,18,10,30,10,4,14,28,1,76,"No"
"629",757,"female","Black or African American",6,"Yes",75,"No",16,10,10,36,17,4,10,31,46,83,"Yes"
"630",270,"male","Asian",8,"Yes",85,"No",7,14,14,35,7,18,12,37,4,72,"Yes"
"631",883,"female","White",6,"No",80,"No",4,18,9,31,18,9,16,43,34,64,"Yes"
"632",251,"male","American Indian or Alaska Native",6,"Yes",71,"No",16,13,13,42,6,11,15,32,16,96,"No"
"633",217,"female","Black or African American",8,"Yes",81,"No",3,13,15,31,11,13,20,44,39,84,"No"
"634",245,"female","Black or African American",6,"Yes",90,"Yes",13,9,15,37,16,16,18,50,38,58,"Yes"
"635",341,"male","Native Hawaiian or Other Pacific Islander",8,"Yes",39,"Yes",18,16,12,46,4,15,18,37,27,48,"Yes"
"636",874,"female","White",8,"Yes",80,"No",14,10,12,36,14,11,14,39,42,26,"Yes"
"637",984,"male","Black or African American",6,"Yes",24,"No",12,4,11,27,6,16,11,33,34,84,"No"
"638",184,"male","Native Hawaiian or Other Pacific Islander",6,"No",62,"No",13,12,15,40,9,3,21,33,38,37,"Yes"
"639",795,"male","American Indian or Alaska Native",8,"No",84,"Yes",18,15,17,50,1,15,20,36,5,83,"Yes"
"640",136,"male","White",7,"Yes",89,"No",17,14,8,39,8,14,11,33,25,91,"No"
"641",231,"male","Asian",6,"No",34,"No",9,15,8,32,13,5,4,22,11,49,"Yes"
"642",59,"male","Native Hawaiian or Other Pacific Islander",8,"No",24,"No",13,16,18,47,11,14,16,41,28,84,"Yes"
"643",476,"male","American Indian or Alaska Native",7,"No",32,"Yes",15,12,19,46,16,9,21,46,27,93,"No"
"644",354,"male","Asian",7,"No",68,"Yes",15,13,7,35,5,4,18,27,24,41,"No"
"645",983,"male","Native Hawaiian or Other Pacific Islander",6,"No",81,"No",6,16,21,43,12,13,21,46,27,72,"No"
"646",23,"female","White",6,"Yes",99,"Yes",13,14,18,45,6,16,20,42,13,86,"Yes"
"647",792,"male","White",8,"Yes",63,"No",18,11,14,43,6,18,5,29,20,29,"Yes"
"648",337,"female","Black or African American",8,"No",57,"Yes",16,18,16,50,12,13,11,36,39,99,"Yes"
"649",310,"male","American Indian or Alaska Native",7,"Yes",64,"No",17,16,5,38,9,14,21,44,44,40,"Yes"
"650",960,"male","American Indian or Alaska Native",7,"No",62,"No",18,3,14,35,16,17,11,44,33,90,"Yes"
"651",485,"male","Asian",6,"Yes",96,"No",12,5,19,36,11,16,15,42,7,79,"Yes"
"652",941,"male","White",7,"No",30,"No",17,15,17,49,9,13,16,38,20,79,"Yes"
"653",840,"male","White",7,"Yes",100,"No",17,17,7,41,18,5,17,40,49,95,"No"
"654",900,"female","Black or African American",7,"Yes",61,"No",15,18,14,47,6,11,21,38,33,57,"Yes"
"655",917,"male","Black or African American",6,"Yes",68,"No",17,8,15,40,17,14,12,43,18,41,"Yes"
"656",133,"male","Asian",7,"Yes",98,"Yes",16,10,19,45,16,14,14,44,13,24,"Yes"
"657",323,"female","American Indian or Alaska Native",6,"No",80,"Yes",11,13,19,43,15,18,19,52,39,96,"Yes"
"658",347,"male","White",6,"No",73,"Yes",9,10,19,38,16,17,19,52,39,36,"Yes"
"659",175,"male","Black or African American",7,"Yes",96,"No",11,16,16,43,3,15,21,39,40,63,"Yes"
"660",864,"female","Native Hawaiian or Other Pacific Islander",8,"Yes",76,"Yes",15,14,18,47,13,7,18,38,3,91,"No"
"661",791,"female","Asian",7,"Yes",65,"No",15,18,12,45,17,13,15,45,7,74,"Yes"
"662",534,"male","Native Hawaiian or Other Pacific Islander",7,"Yes",39,"No",16,13,20,49,10,16,11,37,47,95,"Yes"
"663",514,"female","White",7,"No",63,"No",14,10,8,32,5,16,17,38,7,79,"Yes"
"664",107,"male","Asian",7,"Yes",99,"No",18,17,17,52,12,9,20,41,40,99,"No"
"665",441,"male","White",7,"Yes",79,"No",11,17,15,43,13,17,15,45,27,15,"Yes"
"666",166,"male","American Indian or Alaska Native",6,"Yes",83,"No",15,5,11,31,14,16,17,47,12,25,"No"
"667",824,"male","American Indian or Alaska Native",7,"Yes",86,"Yes",11,11,2,24,9,16,14,39,39,31,"No"
"668",538,"female","Asian",7,"Yes",77,"No",5,10,6,21,12,4,16,32,29,83,"Yes"
"669",342,"male","Black or African American",6,"No",67,"Yes",15,15,17,47,10,11,13,34,50,96,"Yes"
"670",699,"male","Asian",8,"No",10,"Yes",12,17,15,44,18,7,16,41,26,25,"No"
"671",371,"female","White",8,"Yes",85,"No",5,12,6,23,10,12,17,39,37,95,"Yes"
"672",83,"male","American Indian or Alaska Native",6,"Yes",10,"Yes",11,10,12,33,17,13,15,45,48,70,"Yes"
"673",689,"female","American Indian or Alaska Native",8,"Yes",29,"Yes",15,17,20,52,15,10,20,45,3,100,"Yes"
"674",803,"female","Native Hawaiian or Other Pacific Islander",8,"No",83,"Yes",17,13,15,45,14,14,7,35,38,72,"Yes"
"675",286,"female","American Indian or Alaska Native",7,"No",72,"Yes",17,5,10,32,15,8,16,39,5,45,"Yes"
"676",263,"male","American Indian or Alaska Native",6,"No",87,"Yes",2,12,16,30,16,5,21,42,44,62,"No"
"677",241,"male","Asian",8,"Yes",58,"No",9,10,12,31,11,10,20,41,49,60,"No"
"678",659,"male","American Indian or Alaska Native",8,"No",67,"Yes",13,16,18,47,16,18,20,54,16,22,"No"
"679",176,"female","Native Hawaiian or Other Pacific Islander",7,"Yes",99,"No",17,18,17,52,13,9,18,40,33,54,"No"
"680",92,"male","Asian",8,"Yes",64,"No",9,10,10,29,10,18,21,49,36,39,"No"
"681",276,"female","American Indian or Alaska Native",8,"Yes",30,"Yes",3,16,11,30,13,10,16,39,39,80,"No"
"682",591,"male","White",7,"No",71,"Yes",8,10,14,32,11,17,17,45,12,61,"Yes"
"683",501,"male","White",6,"No",99,"No",18,15,5,38,10,9,16,35,1,74,"No"
"684",499,"female","White",7,"Yes",10,"Yes",8,13,14,35,13,10,16,39,35,97,"No"
"685",168,"male","American Indian or Alaska Native",8,"No",37,"No",9,15,20,44,9,18,11,38,10,17,"No"
"686",453,"female","Black or African American",8,"Yes",85,"No",13,17,13,43,11,14,16,41,3,93,"No"
"687",150,"male","American Indian or Alaska Native",7,"Yes",57,"No",14,2,16,32,15,10,21,46,3,8,"Yes"
"688",709,"female","White",8,"No",82,"Yes",14,16,17,47,16,10,7,33,14,97,"No"
"689",3,"male","Asian",6,"Yes",64,"Yes",18,11,11,40,15,13,12,40,13,43,"No"
"690",810,"male","Native Hawaiian or Other Pacific Islander",6,"No",24,"No",13,15,9,37,1,14,9,24,47,54,"Yes"
"691",389,"male","Black or African American",8,"No",34,"Yes",15,4,14,33,17,10,13,40,47,46,"Yes"
"692",776,"male","Black or African American",7,"No",75,"Yes",4,17,9,30,4,11,16,31,35,92,"Yes"
"693",953,"female","American Indian or Alaska Native",6,"No",80,"No",6,13,17,36,12,14,16,42,15,50,"Yes"
"694",741,"male","American Indian or Alaska Native",7,"Yes",89,"No",11,6,7,24,18,11,14,43,15,32,"Yes"
"695",697,"male","White",8,"Yes",67,"No",18,10,19,47,11,18,16,45,28,87,"Yes"
"696",852,"female","Black or African American",6,"No",96,"Yes",15,11,19,45,10,16,8,34,45,88,"No"
"697",151,"male","American Indian or Alaska Native",7,"Yes",99,"No",9,18,18,45,17,6,20,43,48,19,"No"
"698",41,"male","Asian",6,"Yes",78,"No",16,13,12,41,15,12,11,38,1,34,"No"
"699",203,"male","Native Hawaiian or Other Pacific Islander",8,"No",59,"No",1,16,9,26,14,12,18,44,40,84,"Yes"
"700",43,"female","Black or African American",7,"Yes",85,"No",8,2,21,31,11,18,6,35,23,72,"No"
"701",380,"female","American Indian or Alaska Native",8,"Yes",94,"No",8,17,16,41,17,16,20,53,17,37,"No"
"702",309,"male","Native Hawaiian or Other Pacific Islander",6,"No",93,"Yes",14,14,7,35,14,18,8,40,13,81,"No"
"703",474,"male","White",7,"Yes",47,"Yes",18,17,21,56,8,10,17,35,46,45,"No"
"704",297,"male","White",7,"Yes",69,"Yes",9,12,5,26,14,12,17,43,21,56,"No"
"705",759,"male","Asian",7,"No",95,"No",13,4,21,38,14,10,18,42,3,41,"No"
"706",956,"male","Black or African American",7,"No",91,"Yes",15,17,19,51,14,4,7,25,29,31,"Yes"
"707",211,"female","Asian",7,"No",48,"No",17,15,19,51,3,6,10,19,33,87,"No"
"708",587,"male","Asian",6,"Yes",64,"Yes",15,11,6,32,2,14,17,33,26,87,"No"
"709",723,"male","Black or African American",8,"No",94,"Yes",10,13,7,30,16,17,18,51,38,68,"No"
"710",21,"female","White",6,"Yes",85,"Yes",3,17,8,28,14,15,21,50,25,50,"Yes"
"711",738,"male","American Indian or Alaska Native",7,"Yes",94,"No",16,14,15,45,16,14,19,49,50,32,"Yes"
"712",126,"male","Native Hawaiian or Other Pacific Islander",8,"Yes",81,"No",9,16,20,45,13,8,19,40,12,85,"No"
"713",750,"male","Asian",8,"No",97,"No",12,14,13,39,18,16,11,45,4,61,"Yes"
"714",89,"female","White",6,"No",17,"No",4,6,4,14,16,14,15,45,46,87,"No"
"715",213,"female","White",7,"No",83,"Yes",11,17,8,36,10,14,18,42,48,62,"No"
"716",719,"female","White",8,"No",46,"No",13,18,12,43,11,15,13,39,23,53,"Yes"
"717",359,"male","Asian",8,"Yes",53,"Yes",8,12,14,34,17,9,4,30,27,91,"Yes"
"718",167,"male","Native Hawaiian or Other Pacific Islander",6,"No",66,"No",15,16,11,42,17,8,5,30,1,17,"Yes"
"719",367,"female","Native Hawaiian or Other Pacific Islander",7,"No",93,"Yes",10,9,10,29,11,12,13,36,41,96,"Yes"
"720",535,"male","White",6,"Yes",70,"No",18,14,12,44,16,18,20,54,14,73,"No"
"721",869,"female","White",6,"Yes",58,"Yes",18,3,15,36,10,14,14,38,14,68,"No"
"722",396,"male","Native Hawaiian or Other Pacific Islander",6,"No",50,"No",13,16,16,45,4,15,21,40,45,86,"Yes"
"723",962,"male","White",7,"Yes",99,"Yes",8,4,12,24,14,14,15,43,35,88,"No"
"724",873,"female","Native Hawaiian or Other Pacific Islander",8,"No",12,"Yes",17,18,5,40,13,14,10,37,43,81,"No"
"725",378,"female","American Indian or Alaska Native",8,"No",70,"Yes",18,12,12,42,14,6,17,37,36,96,"No"
"726",765,"female","Asian",6,"Yes",74,"Yes",10,11,10,31,15,16,19,50,16,68,"No"
"727",819,"male","Native Hawaiian or Other Pacific Islander",7,"Yes",62,"No",17,14,19,50,18,5,15,38,6,37,"Yes"
"728",498,"male","Black or African American",6,"No",29,"Yes",7,17,20,44,10,16,14,40,50,71,"Yes"
"729",717,"male","American Indian or Alaska Native",8,"Yes",22,"Yes",9,12,14,35,18,12,12,42,11,87,"No"
"730",465,"male","American Indian or Alaska Native",6,"Yes",49,"Yes",14,4,17,35,15,8,9,32,19,94,"Yes"
"731",496,"female","American Indian or Alaska Native",7,"Yes",53,"No",18,5,11,34,9,7,18,34,30,61,"No"
"732",764,"female","American Indian or Alaska Native",8,"Yes",94,"No",18,12,14,44,13,13,19,45,19,31,"Yes"
"733",372,"male","Asian",6,"No",63,"Yes",13,18,17,48,9,18,6,33,7,20,"No"
"734",849,"male","Black or African American",8,"Yes",48,"No",13,13,11,37,16,16,15,47,28,48,"No"
"735",781,"male","White",6,"Yes",74,"No",13,13,21,47,15,8,6,29,8,48,"Yes"
"736",964,"male","White",6,"No",49,"No",18,16,20,54,16,10,16,42,6,63,"No"
"737",947,"male","Native Hawaiian or Other Pacific Islander",8,"No",74,"Yes",13,10,11,34,11,17,7,35,30,47,"No"
"738",753,"female","American Indian or Alaska Native",7,"Yes",98,"No",2,12,20,34,15,18,15,48,41,84,"Yes"
"739",524,"male","Native Hawaiian or Other Pacific Islander",8,"No",45,"Yes",12,11,16,39,13,14,15,42,29,98,"No"
"740",339,"female","Native Hawaiian or Other Pacific Islander",8,"No",68,"Yes",5,16,11,32,7,17,9,33,31,50,"No"
"741",696,"male","American Indian or Alaska Native",6,"Yes",61,"Yes",17,15,19,51,14,17,16,47,8,61,"Yes"
"742",222,"female","Black or African American",7,"Yes",76,"No",18,18,8,44,11,12,19,42,26,73,"Yes"
"743",580,"female","Native Hawaiian or Other Pacific Islander",6,"No",34,"No",18,5,12,35,5,7,6,18,12,82,"No"
"744",503,"female","Native Hawaiian or Other Pacific Islander",6,"Yes",70,"Yes",11,13,11,35,17,12,13,42,2,37,"No"
"745",784,"female","Asian",8,"Yes",58,"Yes",11,16,6,33,9,6,21,36,12,56,"Yes"
"746",218,"female","Native Hawaiian or Other Pacific Islander",6,"No",93,"No",14,17,2,33,12,18,16,46,7,56,"No"
"747",787,"male","American Indian or Alaska Native",8,"No",97,"No",13,7,20,40,10,12,21,43,50,98,"No"
"748",673,"female","Native Hawaiian or Other Pacific Islander",7,"No",80,"Yes",5,17,14,36,18,15,10,43,20,65,"Yes"
"749",370,"female","Native Hawaiian or Other Pacific Islander",6,"No",60,"Yes",15,9,17,41,16,12,13,41,32,73,"Yes"
"750",375,"male","White",6,"No",78,"No",2,17,17,36,7,18,10,35,19,41,"No"
"751",440,"male","American Indian or Alaska Native",8,"No",82,"No",17,18,16,51,15,15,13,43,33,51,"Yes"
"752",321,"female","American Indian or Alaska Native",7,"Yes",31,"Yes",17,15,17,49,18,17,20,55,12,75,"No"
"753",570,"female","American Indian or Alaska Native",6,"No",37,"No",5,14,21,40,14,17,16,47,41,63,"No"
"754",706,"male","White",6,"Yes",69,"Yes",3,17,7,27,16,17,21,54,19,91,"Yes"
"755",55,"female","Native Hawaiian or Other Pacific Islander",6,"No",20,"No",17,18,14,49,12,4,9,25,45,75,"Yes"
"756",346,"female","Asian",7,"Yes",90,"Yes",12,12,17,41,11,12,14,37,36,65,"No"
"757",609,"female","Native Hawaiian or Other Pacific Islander",7,"No",94,"No",11,7,2,20,11,10,16,37,5,57,"Yes"
"758",28,"female","Native Hawaiian or Other Pacific Islander",8,"Yes",66,"No",5,18,18,41,15,17,4,36,20,30,"Yes"
"759",668,"male","White",8,"Yes",92,"Yes",10,12,15,37,18,16,15,49,4,96,"Yes"
"760",816,"male","Black or African American",7,"No",68,"Yes",15,7,17,39,8,17,16,41,47,52,"No"
"761",0,"male","Native Hawaiian or Other Pacific Islander",7,"No",45,"No",12,12,8,32,18,18,7,43,20,28,"Yes"
"762",851,"female","Asian",7,"Yes",87,"Yes",13,2,19,34,13,10,18,41,28,92,"No"
"763",942,"female","American Indian or Alaska Native",7,"No",67,"Yes",15,11,16,42,13,7,17,37,4,85,"Yes"
"764",229,"female","White",7,"No",66,"No",13,2,5,20,15,18,16,49,24,98,"Yes"
"765",253,"female","American Indian or Alaska Native",6,"Yes",21,"Yes",6,14,4,24,18,12,19,49,6,66,"No"
"766",384,"female","Black or African American",8,"No",85,"No",17,18,20,55,18,6,20,44,45,60,"No"
"767",174,"female","White",8,"No",93,"Yes",15,6,20,41,14,8,3,25,21,98,"No"
"768",509,"female","White",7,"Yes",55,"Yes",10,18,20,48,15,18,17,50,33,69,"Yes"
"769",216,"female","Asian",8,"No",52,"Yes",10,10,7,27,15,10,19,44,17,49,"Yes"
"770",747,"male","Asian",7,"Yes",99,"Yes",18,17,19,54,7,13,17,37,48,91,"Yes"
"771",844,"male","Black or African American",6,"No",55,"Yes",15,8,13,36,3,8,15,26,22,46,"Yes"
"772",545,"male","White",6,"No",11,"No",5,15,10,30,14,9,19,42,46,15,"No"
"773",955,"male","Black or African American",8,"Yes",79,"No",17,16,9,42,9,18,7,34,32,44,"No"
"774",716,"male","American Indian or Alaska Native",8,"No",44,"No",16,12,20,48,12,13,19,44,45,51,"Yes"
"775",602,"male","White",8,"No",92,"Yes",8,8,13,29,11,13,13,37,50,88,"No"
"776",760,"female","Native Hawaiian or Other Pacific Islander",8,"No",63,"Yes",13,18,17,48,13,8,18,39,9,64,"Yes"
"777",302,"female","Native Hawaiian or Other Pacific Islander",6,"Yes",55,"No",7,11,4,22,9,16,21,46,49,96,"No"
"778",40,"female","White",8,"No",85,"Yes",18,17,13,48,12,15,18,45,27,27,"No"
"779",69,"male","Native Hawaiian or Other Pacific Islander",8,"Yes",16,"No",15,16,11,42,10,17,18,45,15,82,"No"
"780",407,"male","Native Hawaiian or Other Pacific Islander",6,"Yes",74,"Yes",18,17,20,55,11,14,17,42,8,100,"Yes"
"781",332,"male","Asian",8,"Yes",95,"Yes",5,10,18,33,16,18,13,47,47,64,"Yes"
"782",572,"male","American Indian or Alaska Native",6,"Yes",62,"Yes",8,12,12,32,15,7,18,40,26,88,"No"
"783",104,"male","Asian",6,"No",86,"Yes",10,8,17,35,14,18,19,51,43,84,"Yes"
"784",205,"male","Black or African American",8,"Yes",92,"No",4,15,13,32,10,3,18,31,14,86,"Yes"
"785",36,"female","Native Hawaiian or Other Pacific Islander",6,"Yes",68,"No",15,15,19,49,10,15,12,37,22,100,"Yes"
"786",24,"male","Black or African American",6,"Yes",74,"No",4,13,9,26,10,7,3,20,6,78,"No"
"787",409,"male","Native Hawaiian or Other Pacific Islander",8,"Yes",63,"No",11,16,20,47,5,7,21,33,14,44,"No"
"788",732,"female","Black or African American",6,"No",86,"Yes",12,18,13,43,17,8,12,37,49,25,"No"
"789",35,"male","Native Hawaiian or Other Pacific Islander",7,"No",86,"Yes",6,14,13,33,17,17,10,44,26,94,"No"
"790",861,"male","Native Hawaiian or Other Pacific Islander",6,"No",81,"Yes",7,4,16,27,16,17,19,52,18,43,"Yes"
"791",823,"female","White",6,"No",90,"Yes",17,12,16,45,14,14,21,49,1,70,"Yes"
"792",949,"female","Native Hawaiian or Other Pacific Islander",7,"No",97,"No",15,16,21,52,9,15,8,32,23,37,"Yes"
"793",110,"male","American Indian or Alaska Native",8,"No",87,"Yes",14,13,4,31,12,10,14,36,15,20,"Yes"
"794",930,"female","American Indian or Alaska Native",6,"Yes",87,"No",15,6,16,37,14,18,12,44,50,30,"No"
"795",998,"female","American Indian or Alaska Native",7,"No",85,"Yes",15,1,14,30,8,4,19,31,16,66,"No"
"796",169,"male","Asian",6,"Yes",88,"No",14,5,17,36,17,14,21,52,45,70,"Yes"
"797",821,"female","White",8,"No",42,"Yes",4,16,17,37,8,3,14,25,6,95,"No"
"798",7,"female","White",8,"No",64,"Yes",14,17,19,50,17,7,20,44,19,60,"No"
"799",90,"female","Asian",8,"No",70,"No",8,13,2,23,12,12,12,36,27,17,"No"
"800",972,"female","White",7,"No",70,"No",17,4,8,29,11,14,15,40,22,66,"No"
"801",97,"male","White",6,"Yes",46,"No",17,15,18,50,10,14,21,45,46,56,"No"
"802",319,"female","Black or African American",7,"Yes",95,"No",11,17,14,42,18,9,18,45,13,58,"No"
"803",306,"female","American Indian or Alaska Native",8,"Yes",84,"Yes",10,1,18,29,14,17,9,40,43,89,"Yes"
"804",461,"male","Native Hawaiian or Other Pacific Islander",7,"No",74,"Yes",3,9,16,28,8,18,21,47,49,89,"No"
"805",427,"female","White",6,"Yes",73,"No",16,2,8,26,6,15,20,41,47,68,"No"
"806",583,"female","American Indian or Alaska Native",8,"No",13,"No",14,15,10,39,13,17,19,49,45,66,"No"
"807",892,"male","American Indian or Alaska Native",6,"No",34,"No",10,17,10,37,17,18,16,51,7,28,"No"
"808",520,"male","Asian",6,"Yes",7,"Yes",11,11,20,42,2,16,18,36,38,82,"No"
"809",401,"male","American Indian or Alaska Native",7,"Yes",83,"No",12,18,4,34,16,11,19,46,40,43,"Yes"
"810",278,"female","White",7,"Yes",83,"Yes",18,16,17,51,9,16,4,29,43,33,"Yes"
"811",688,"female","Native Hawaiian or Other Pacific Islander",8,"Yes",96,"No",14,18,17,49,18,17,21,56,47,71,"Yes"
"812",131,"female","American Indian or Alaska Native",8,"Yes",97,"No",12,14,14,40,11,13,16,40,5,86,"Yes"
"813",915,"male","Native Hawaiian or Other Pacific Islander",7,"No",96,"No",13,16,19,48,5,9,3,17,36,38,"Yes"
"814",562,"male","White",8,"Yes",35,"Yes",7,17,20,44,16,15,20,51,25,63,"Yes"
"815",641,"male","Native Hawaiian or Other Pacific Islander",6,"No",67,"No",9,17,19,45,16,10,15,41,7,79,"No"
"816",334,"female","Asian",6,"Yes",86,"Yes",12,13,19,44,18,8,16,42,6,58,"Yes"
"817",283,"male","Asian",7,"Yes",81,"Yes",6,9,10,25,10,15,17,42,42,80,"No"
"818",674,"male","Black or African American",8,"No",52,"Yes",18,8,15,41,15,11,21,47,13,49,"Yes"
"819",155,"male","Asian",7,"No",95,"Yes",17,7,11,35,11,4,9,24,25,55,"No"
"820",357,"male","White",6,"Yes",34,"Yes",17,14,18,49,13,6,20,39,39,60,"Yes"
"821",62,"male","Black or African American",7,"No",96,"Yes",17,6,21,44,13,7,13,33,39,61,"Yes"
"822",623,"male","White",8,"No",43,"Yes",11,16,14,41,17,12,21,50,30,91,"No"
"823",486,"female","White",7,"Yes",95,"Yes",13,18,12,43,14,8,21,43,44,80,"No"
"824",141,"female","White",7,"No",99,"No",9,9,18,36,5,12,21,38,29,91,"No"
"825",365,"female","Black or African American",7,"Yes",62,"Yes",12,16,21,49,15,11,18,44,27,67,"Yes"
"826",711,"female","Asian",8,"Yes",32,"Yes",15,15,18,48,8,11,14,33,28,63,"Yes"
"827",542,"male","Asian",8,"No",47,"No",11,17,5,33,13,16,18,47,16,21,"Yes"
"828",528,"female","Black or African American",7,"Yes",93,"No",14,9,9,32,14,12,4,30,40,41,"No"
"829",560,"female","American Indian or Alaska Native",7,"No",75,"Yes",12,13,11,36,4,17,11,32,8,99,"No"
"830",294,"female","White",8,"No",22,"No",16,15,20,51,18,13,18,49,24,83,"No"
"831",305,"male","American Indian or Alaska Native",7,"No",71,"No",11,4,10,25,17,15,16,48,27,88,"Yes"
"832",255,"female","Native Hawaiian or Other Pacific Islander",6,"Yes",99,"Yes",6,16,16,38,16,14,21,51,22,74,"Yes"
"833",974,"female","American Indian or Alaska Native",6,"No",63,"No",15,7,11,33,14,18,16,48,30,77,"No"
"834",748,"male","Native Hawaiian or Other Pacific Islander",7,"No",79,"Yes",15,17,5,37,2,6,10,18,43,78,"No"
"835",586,"female","Native Hawaiian or Other Pacific Islander",7,"Yes",22,"No",11,5,2,18,17,15,16,48,37,89,"No"
"836",75,"female","Native Hawaiian or Other Pacific Islander",7,"Yes",64,"Yes",18,7,15,40,14,11,17,42,29,21,"Yes"
"837",752,"female","Native Hawaiian or Other Pacific Islander",7,"No",81,"Yes",4,12,18,34,5,15,14,34,29,52,"Yes"
"838",872,"female","Asian",8,"Yes",34,"Yes",14,5,4,23,9,18,10,37,37,42,"Yes"
"839",388,"male","Asian",7,"Yes",70,"Yes",12,18,9,39,7,17,20,44,11,74,"Yes"
"840",905,"male","American Indian or Alaska Native",6,"Yes",71,"No",17,16,1,34,12,18,10,40,13,24,"Yes"
"841",265,"female","Native Hawaiian or Other Pacific Islander",7,"No",71,"No",12,12,5,29,3,14,4,21,39,5,"Yes"
"842",81,"male","Native Hawaiian or Other Pacific Islander",7,"Yes",96,"Yes",16,14,17,47,10,13,6,29,15,40,"Yes"
"843",939,"female","White",7,"Yes",94,"No",12,14,20,46,12,15,10,37,3,50,"No"
"844",909,"female","Asian",6,"Yes",90,"No",17,13,20,50,2,7,4,13,32,28,"Yes"
"845",907,"female","White",6,"No",84,"No",10,8,21,39,14,14,12,40,39,42,"No"
"846",221,"male","American Indian or Alaska Native",6,"No",12,"No",16,18,15,49,18,12,18,48,40,55,"No"
"847",588,"female","American Indian or Alaska Native",6,"Yes",83,"No",13,17,10,40,7,1,10,18,24,57,"Yes"
"848",966,"male","White",8,"No",99,"Yes",10,16,21,47,13,8,14,35,42,54,"Yes"
"849",855,"male","White",6,"No",75,"No",9,4,13,26,17,7,15,39,10,84,"No"
"850",105,"female","Native Hawaiian or Other Pacific Islander",7,"Yes",53,"No",11,15,16,42,17,17,18,52,11,42,"Yes"
"851",260,"female","White",8,"Yes",47,"No",17,14,8,39,18,14,12,44,35,99,"No"
"852",232,"female","American Indian or Alaska Native",7,"Yes",82,"No",15,8,17,40,13,5,19,37,17,93,"Yes"
"853",653,"female","American Indian or Alaska Native",8,"Yes",44,"No",14,18,10,42,10,13,17,40,13,31,"Yes"
"854",352,"female","Asian",7,"No",86,"No",12,11,9,32,18,18,13,49,37,100,"No"
"855",111,"male","White",8,"No",86,"Yes",18,10,9,37,8,10,15,33,2,100,"Yes"
"856",948,"female","American Indian or Alaska Native",6,"Yes",91,"Yes",12,18,9,39,17,6,10,33,28,32,"No"
"857",115,"male","White",7,"Yes",41,"Yes",17,13,7,37,8,11,18,37,2,69,"No"
"858",686,"female","Black or African American",8,"Yes",89,"Yes",6,9,18,33,18,18,14,50,45,31,"No"
"859",381,"male","Black or African American",8,"Yes",99,"Yes",15,17,4,36,14,14,20,48,47,95,"Yes"
"860",935,"male","American Indian or Alaska Native",6,"No",97,"No",12,9,20,41,15,1,17,33,21,57,"No"
"861",832,"male","Asian",7,"No",95,"Yes",17,10,12,39,7,8,14,29,18,79,"No"
"862",922,"female","Native Hawaiian or Other Pacific Islander",7,"No",31,"Yes",10,13,15,38,16,14,21,51,4,96,"Yes"
"863",690,"male","Asian",6,"Yes",81,"No",16,14,16,46,18,13,6,37,16,90,"Yes"
"864",287,"female","Asian",6,"No",53,"No",6,17,2,25,18,13,21,52,9,30,"No"
"865",577,"female","Native Hawaiian or Other Pacific Islander",7,"No",36,"Yes",16,4,19,39,15,16,19,50,37,74,"No"
"866",755,"female","Asian",6,"Yes",55,"Yes",10,10,12,32,14,15,19,48,20,100,"Yes"
"867",820,"male","White",8,"Yes",94,"No",9,16,12,37,11,6,20,37,45,88,"No"
"868",435,"male","Black or African American",7,"Yes",95,"No",15,17,18,50,5,16,6,27,43,87,"No"
"869",662,"male","Black or African American",7,"No",83,"Yes",17,16,14,47,14,18,19,51,29,93,"Yes"
"870",16,"male","Black or African American",6,"No",6,"Yes",17,16,15,48,7,8,8,23,49,96,"No"
"871",811,"male","Black or African American",6,"Yes",61,"Yes",10,12,16,38,7,8,2,17,9,15,"Yes"
"872",57,"female","Asian",7,"No",87,"Yes",12,9,16,37,18,4,19,41,33,30,"Yes"
"873",561,"female","Asian",8,"Yes",31,"No",4,4,10,18,7,12,9,28,1,65,"No"
"874",891,"female","Native Hawaiian or Other Pacific Islander",6,"Yes",93,"No",16,6,6,28,7,15,11,33,25,26,"No"
"875",324,"male","Asian",6,"No",85,"No",13,5,12,30,15,5,18,38,2,81,"No"
"876",400,"female","American Indian or Alaska Native",8,"No",52,"Yes",18,5,16,39,17,18,17,52,12,69,"Yes"
"877",918,"female","Asian",6,"Yes",73,"Yes",10,18,20,48,1,17,1,19,42,100,"Yes"
"878",1,"female","White",7,"No",92,"Yes",11,12,12,35,17,14,10,41,11,86,"No"
"879",868,"female","Asian",8,"Yes",62,"Yes",15,13,21,49,6,17,16,39,35,88,"No"
"880",969,"male","Black or African American",8,"Yes",84,"Yes",16,17,13,46,15,17,6,38,46,72,"No"
"881",938,"male","American Indian or Alaska Native",6,"Yes",50,"Yes",15,16,21,52,15,6,21,42,19,18,"Yes"
"882",987,"male","Black or African American",6,"No",61,"No",8,7,13,28,13,10,14,37,39,90,"No"
"883",307,"male","American Indian or Alaska Native",8,"Yes",89,"Yes",11,14,18,43,18,13,14,45,31,88,"No"
"884",645,"male","White",7,"Yes",98,"Yes",13,2,12,27,18,14,4,36,50,89,"Yes"
"885",472,"male","Black or African American",6,"Yes",68,"No",17,13,16,46,18,11,20,49,1,37,"No"
"886",343,"female","American Indian or Alaska Native",7,"No",51,"Yes",16,16,13,45,8,17,21,46,48,14,"No"
"887",636,"male","Asian",7,"Yes",54,"No",14,10,15,39,17,15,5,37,15,84,"Yes"
"888",322,"male","American Indian or Alaska Native",6,"No",78,"No",14,11,16,41,9,18,20,47,47,96,"Yes"
"889",153,"male","Native Hawaiian or Other Pacific Islander",6,"Yes",32,"No",16,8,13,37,15,16,5,36,25,83,"Yes"
"890",195,"male","Native Hawaiian or Other Pacific Islander",6,"Yes",100,"No",6,13,21,40,12,10,5,27,48,54,"No"
"891",271,"male","White",8,"Yes",97,"Yes",8,8,21,37,16,14,21,51,10,78,"Yes"
"892",799,"female","American Indian or Alaska Native",8,"Yes",55,"Yes",9,2,14,25,6,11,21,38,50,21,"No"
"893",608,"female","Asian",6,"Yes",58,"No",18,10,3,31,17,18,21,56,33,92,"Yes"
"894",377,"male","American Indian or Alaska Native",7,"No",43,"No",14,17,21,52,18,7,4,29,16,60,"No"
"895",374,"male","American Indian or Alaska Native",7,"Yes",71,"Yes",7,16,6,29,12,10,8,30,20,100,"No"
"896",916,"female","American Indian or Alaska Native",7,"No",65,"No",16,18,12,46,16,11,9,36,10,90,"No"
"897",996,"female","Asian",6,"Yes",44,"Yes",17,18,19,54,13,10,19,42,29,97,"No"
"898",404,"female","Native Hawaiian or Other Pacific Islander",7,"Yes",94,"Yes",3,8,10,21,16,13,20,49,49,93,"No"
"899",556,"female","White",7,"No",86,"No",1,15,10,26,2,3,13,18,49,86,"Yes"
"900",331,"male","Native Hawaiian or Other Pacific Islander",7,"Yes",79,"No",13,8,9,30,15,5,13,33,49,43,"Yes"
"901",487,"male","Native Hawaiian or Other Pacific Islander",6,"No",81,"No",3,7,21,31,9,15,20,44,34,91,"Yes"
"902",995,"female","White",7,"Yes",39,"No",11,10,17,38,14,9,17,40,39,82,"Yes"
"903",843,"male","American Indian or Alaska Native",7,"No",73,"No",15,4,16,35,17,3,12,32,38,90,"Yes"
"904",471,"female","Black or African American",8,"Yes",100,"Yes",14,16,14,44,18,15,9,42,17,55,"No"
"905",735,"female","White",7,"No",43,"No",11,15,13,39,13,16,18,47,27,27,"Yes"
"906",638,"female","Asian",8,"No",81,"No",17,9,10,36,10,14,15,39,24,95,"Yes"
"907",952,"male","White",7,"Yes",84,"Yes",15,18,20,53,7,15,18,40,15,94,"Yes"
"908",311,"female","Native Hawaiian or Other Pacific Islander",6,"No",85,"No",15,15,16,46,17,17,11,45,32,89,"No"
"909",293,"male","Asian",6,"Yes",49,"No",10,14,21,45,15,9,12,36,49,28,"Yes"
"910",575,"male","White",6,"No",91,"No",14,17,17,48,17,16,12,45,3,40,"No"
"911",651,"male","Black or African American",6,"Yes",33,"Yes",14,7,21,42,12,9,17,38,43,17,"Yes"
"912",116,"female","Black or African American",6,"Yes",24,"No",9,16,8,33,10,13,15,38,35,79,"No"
"913",478,"female","Native Hawaiian or Other Pacific Islander",8,"Yes",64,"No",14,11,17,42,7,15,18,40,2,91,"Yes"
"914",898,"female","White",7,"No",79,"Yes",16,17,20,53,16,17,14,47,30,60,"Yes"
"915",139,"male","Asian",8,"No",91,"No",10,3,17,30,17,15,7,39,18,49,"Yes"
"916",594,"female","Asian",8,"No",46,"Yes",18,9,18,45,13,5,5,23,15,54,"No"
"917",903,"male","White",8,"No",88,"No",8,18,20,46,10,14,16,40,31,91,"No"
"918",49,"male","Native Hawaiian or Other Pacific Islander",7,"Yes",38,"Yes",6,17,21,44,10,1,21,32,13,87,"Yes"
"919",978,"male","Black or African American",8,"No",64,"Yes",17,8,19,44,14,8,11,33,10,55,"No"
"920",237,"female","American Indian or Alaska Native",8,"Yes",50,"No",4,17,14,35,10,13,20,43,24,14,"Yes"
"921",839,"female","Black or African American",7,"No",99,"No",12,16,21,49,18,4,15,37,31,96,"Yes"
"922",818,"female","Asian",6,"Yes",57,"Yes",16,14,21,51,13,13,19,45,6,34,"Yes"
"923",634,"female","White",8,"Yes",94,"Yes",15,14,17,46,3,15,2,20,30,9,"No"
"924",618,"male","American Indian or Alaska Native",8,"No",89,"Yes",13,12,4,29,11,10,8,29,28,59,"No"
"925",406,"female","White",7,"No",67,"Yes",9,13,14,36,12,14,19,45,23,62,"No"
"926",737,"male","Asian",8,"Yes",45,"No",7,8,15,30,8,12,13,33,34,46,"Yes"
"927",431,"female","Native Hawaiian or Other Pacific Islander",6,"Yes",93,"No",15,18,16,49,15,9,12,36,43,83,"No"
"928",72,"female","Asian",7,"Yes",41,"Yes",16,13,21,50,11,14,21,46,8,72,"Yes"
"929",442,"male","Asian",6,"Yes",78,"Yes",4,12,15,31,16,12,19,47,35,46,"Yes"
"930",273,"male","Black or African American",8,"Yes",31,"Yes",17,15,18,50,17,11,15,43,28,91,"No"
"931",44,"male","Asian",7,"Yes",13,"No",9,7,14,30,17,16,8,41,14,34,"Yes"
"932",817,"female","White",8,"Yes",80,"No",13,11,16,40,10,15,14,39,50,97,"Yes"
"933",418,"female","Black or African American",7,"Yes",56,"No",14,8,7,29,8,14,9,31,5,64,"No"
"934",397,"male","American Indian or Alaska Native",7,"Yes",40,"Yes",9,14,21,44,10,10,16,36,50,74,"No"
"935",27,"male","American Indian or Alaska Native",7,"No",33,"No",17,15,17,49,9,15,15,39,40,65,"No"
"936",480,"female","Asian",6,"Yes",91,"Yes",3,2,16,21,7,14,10,31,38,21,"No"
"937",685,"female","American Indian or Alaska Native",6,"No",100,"Yes",18,18,15,51,6,18,17,41,3,87,"Yes"
"938",61,"female","American Indian or Alaska Native",7,"Yes",98,"Yes",18,18,17,53,11,17,12,40,40,38,"No"
"939",335,"female","Native Hawaiian or Other Pacific Islander",8,"Yes",80,"No",12,15,14,41,1,18,20,39,13,88,"No"
"940",454,"female","Native Hawaiian or Other Pacific Islander",6,"Yes",88,"No",8,16,18,42,10,7,5,22,16,94,"Yes"
"941",152,"male","American Indian or Alaska Native",6,"Yes",92,"No",13,18,8,39,2,16,21,39,31,74,"No"
"942",669,"male","Native Hawaiian or Other Pacific Islander",8,"Yes",61,"No",15,18,18,51,11,7,21,39,29,51,"Yes"
"943",652,"male","American Indian or Alaska Native",7,"No",97,"Yes",17,8,13,38,18,11,19,48,11,98,"No"
"944",413,"male","Native Hawaiian or Other Pacific Islander",7,"Yes",75,"No",9,15,9,33,10,1,19,30,17,95,"Yes"
"945",484,"female","Black or African American",7,"No",69,"No",14,7,19,40,12,15,21,48,49,96,"Yes"
"946",754,"female","White",6,"Yes",76,"Yes",17,7,19,43,11,2,15,28,5,58,"Yes"
"947",794,"male","Black or African American",8,"No",84,"Yes",18,12,11,41,5,15,17,37,2,100,"Yes"
"948",544,"female","White",7,"Yes",100,"Yes",15,6,18,39,16,18,11,45,11,74,"No"
"949",117,"female","Asian",8,"Yes",45,"No",3,11,19,33,18,6,4,28,4,72,"No"
"950",106,"female","American Indian or Alaska Native",8,"Yes",81,"Yes",18,7,19,44,16,14,14,44,11,81,"No"
"951",320,"female","White",8,"Yes",54,"No",16,16,14,46,12,18,16,46,8,98,"No"
"952",584,"male","White",7,"Yes",37,"Yes",15,8,12,35,18,15,10,43,15,13,"No"
"953",779,"female","White",6,"Yes",85,"No",15,1,10,26,17,12,14,43,14,89,"No"
"954",751,"female","American Indian or Alaska Native",8,"Yes",89,"Yes",18,9,17,44,9,6,19,34,44,86,"Yes"
"955",783,"female","American Indian or Alaska Native",8,"Yes",94,"No",6,18,11,35,6,15,20,41,2,92,"Yes"
"956",10,"female","White",7,"No",94,"No",17,18,17,52,17,18,13,48,7,45,"No"
"957",681,"male","American Indian or Alaska Native",7,"Yes",85,"Yes",11,11,17,39,4,14,18,36,4,61,"No"
"958",13,"female","Native Hawaiian or Other Pacific Islander",6,"No",62,"Yes",1,11,9,21,14,9,12,35,5,92,"No"
"959",439,"male","American Indian or Alaska Native",8,"No",70,"Yes",13,8,12,33,15,5,9,29,42,88,"Yes"
"960",772,"female","White",6,"Yes",72,"Yes",16,11,12,39,11,16,20,47,16,21,"Yes"
"961",338,"female","Asian",7,"Yes",92,"Yes",8,18,11,37,18,5,13,36,50,75,"Yes"
"962",246,"female","Black or African American",8,"No",62,"Yes",13,11,18,42,15,9,21,45,49,73,"Yes"
"963",149,"female","Black or African American",8,"Yes",34,"No",9,16,13,38,11,3,19,33,2,87,"Yes"
"964",76,"male","Asian",7,"Yes",60,"Yes",13,18,6,37,12,11,21,44,10,65,"Yes"
"965",102,"female","Black or African American",8,"No",93,"Yes",9,13,11,33,12,8,12,32,38,28,"Yes"
"966",473,"male","White",8,"No",84,"No",10,3,13,26,3,13,20,36,41,56,"Yes"
"967",731,"male","Native Hawaiian or Other Pacific Islander",8,"Yes",97,"Yes",17,17,20,54,1,17,9,27,41,98,"No"
"968",483,"female","American Indian or Alaska Native",7,"No",52,"Yes",15,11,21,47,6,8,19,33,23,45,"Yes"
"969",910,"female","American Indian or Alaska Native",8,"Yes",15,"No",15,10,7,32,15,18,16,49,48,83,"Yes"
"970",728,"female","Black or African American",6,"No",54,"Yes",13,16,9,38,10,13,19,42,43,86,"Yes"
"971",284,"female","Native Hawaiian or Other Pacific Islander",6,"Yes",87,"Yes",10,11,18,39,6,15,7,28,15,93,"No"
"972",957,"female","Asian",7,"Yes",73,"No",17,6,16,39,14,8,18,40,33,70,"Yes"
"973",145,"male","Asian",7,"Yes",98,"No",18,18,7,43,5,1,16,22,17,54,"No"
"974",727,"female","White",7,"Yes",84,"No",10,9,12,31,14,3,7,24,6,40,"Yes"
"975",733,"male","Asian",8,"No",72,"No",9,14,19,42,13,12,11,36,7,75,"Yes"
"976",362,"male","White",6,"No",77,"No",2,16,19,37,12,7,19,38,9,60,"Yes"
"977",411,"male","White",6,"Yes",80,"Yes",13,10,19,42,16,17,21,54,12,100,"Yes"
"978",526,"female","American Indian or Alaska Native",7,"No",56,"Yes",12,3,6,21,18,14,14,46,45,59,"No"
"979",590,"female","Asian",6,"No",82,"No",10,16,12,38,17,14,20,51,21,55,"Yes"
"980",163,"female","Asian",7,"Yes",92,"No",16,7,16,39,17,8,18,43,2,87,"No"
"981",683,"female","Black or African American",6,"Yes",33,"Yes",10,7,5,22,11,11,19,41,12,86,"No"
"982",327,"female","Native Hawaiian or Other Pacific Islander",7,"No",67,"No",10,12,9,31,14,14,11,39,15,79,"Yes"
"983",146,"male","Asian",7,"Yes",93,"No",15,5,11,31,6,16,11,33,24,84,"No"
"984",225,"female","Black or African American",7,"No",66,"Yes",9,17,7,33,10,16,19,45,19,85,"Yes"
"985",610,"female","Black or African American",8,"Yes",86,"Yes",16,16,9,41,8,11,17,36,42,48,"Yes"
"986",277,"female","American Indian or Alaska Native",7,"No",79,"No",10,11,19,40,8,3,15,26,20,74,"No"
"987",187,"male","White",7,"No",78,"No",17,4,11,32,18,10,8,36,29,67,"No"
"988",607,"female","Native Hawaiian or Other Pacific Islander",6,"Yes",96,"Yes",10,16,20,46,15,15,19,49,35,95,"No"
"989",889,"male","Black or African American",7,"No",78,"No",16,8,16,40,12,13,14,39,14,91,"No"
"990",387,"female","Black or African American",6,"Yes",63,"Yes",16,14,17,47,5,11,21,37,26,43,"No"
"991",553,"male","Native Hawaiian or Other Pacific Islander",7,"No",65,"Yes",17,13,20,50,10,12,7,29,14,100,"No"
"992",142,"female","White",7,"Yes",53,"Yes",14,9,19,42,16,14,9,39,37,32,"No"
"993",965,"male","Asian",6,"No",87,"Yes",16,12,12,40,13,13,21,47,8,86,"Yes"
"994",180,"male","American Indian or Alaska Native",8,"No",46,"Yes",10,18,13,41,15,5,9,29,13,86,"No"
"995",521,"female","Black or African American",8,"Yes",33,"Yes",13,12,11,36,16,16,12,44,12,87,"No"
"996",182,"male","White",7,"Yes",71,"Yes",18,11,16,45,9,15,17,41,10,80,"No"
"997",812,"female","White",8,"No",53,"No",15,17,15,47,6,4,12,22,41,51,"No"
"998",822,"female","Black or African American",6,"Yes",81,"Yes",17,6,18,41,18,10,19,47,42,25,"No"
"999",721,"male","Black or African American",7,"Yes",69,"No",17,17,20,54,11,7,20,38,40,94,"No"
"1000",366,"male","White",7,"Yes",58,"No",14,15,12,41,5,18,8,31,9,73,"Yes"
