"ID","gender","ethnicity","grade","specialEducation","prevTestScore","pastDisciplinary","socialBehavior","academicBehavior","emotionalBehavior","totalBehavior","trsSocialBehavior","trsAcademicBehavior","trsEmotionalBehavior","trsTotalBehavior","midasRisk","futureTestScore","futureDisciplinary"
657,"female","Black or African American",6,"No",44,"Yes",6,14,19,39,11,4,1,16,85,70,"Yes"
477,"female","American Indian or Alaska Native",8,"Yes",92,"No",9,17,19,45,6,11,16,33,87,78,"Yes"
680,"male","Black or African American",8,"No",77,"Yes",9,16,16,41,15,10,21,46,19,76,"Yes"
32,"male","White",6,"No",49,"Yes",14,12,15,41,16,10,14,40,2,44,"Yes"
578,"male","American Indian or Alaska Native",8,"Yes",79,"No",9,8,21,38,18,18,8,44,83,74,"Yes"
165,"male","Native Hawaiian or Other Pacific Islander",6,"No",14,"Yes",15,17,8,40,2,13,7,22,54,11,"Yes"
78,"female","American Indian or Alaska Native",8,"No",49,"Yes",13,15,12,40,12,18,18,48,71,47,"Yes"
870,"female","White",7,"No",87,"No",18,17,11,46,6,16,20,42,17,84,"No"
549,"female","American Indian or Alaska Native",7,"Yes",24,"Yes",18,16,17,51,17,6,17,40,25,12,"No"
333,"female","American Indian or Alaska Native",7,"No",69,"No",11,13,18,42,13,11,20,44,16,16,"Yes"
557,"female","Black or African American",8,"Yes",80,"No",15,15,5,35,13,16,5,34,89,78,"Yes"
694,"female","Asian",6,"No",44,"No",3,12,9,24,15,14,17,46,84,39,"Yes"
134,"male","American Indian or Alaska Native",7,"Yes",32,"No",8,18,10,36,15,18,21,54,89,60,"Yes"
730,"male","Black or African American",8,"No",9,"Yes",16,15,14,45,14,14,14,42,32,99,"Yes"
718,"male","White",7,"No",96,"No",12,17,17,46,13,12,18,43,71,89,"Yes"
100,"male","White",6,"No",89,"No",16,6,14,36,18,17,17,52,61,97,"No"
161,"female","White",6,"No",44,"Yes",13,15,13,41,18,13,17,48,76,88,"No"
940,"male","Black or African American",8,"No",86,"Yes",15,10,11,36,7,13,9,29,2,58,"No"
679,"male","Black or African American",8,"No",45,"No",11,12,8,31,1,4,14,19,38,85,"No"
308,"female","Asian",8,"No",58,"Yes",17,13,12,42,17,7,7,31,63,89,"No"
982,"female","American Indian or Alaska Native",7,"Yes",36,"Yes",8,3,15,26,11,18,21,50,37,53,"Yes"
296,"male","White",8,"Yes",99,"Yes",16,17,16,49,2,3,18,23,100,75,"Yes"
902,"male","White",7,"Yes",68,"No",13,16,19,48,14,11,3,28,34,88,"No"
831,"female","Asian",8,"No",69,"Yes",17,14,20,51,17,7,14,38,60,92,"No"
658,"male","Black or African American",6,"Yes",97,"Yes",18,12,10,40,15,12,5,32,40,91,"No"
299,"male","Asian",6,"No",89,"No",18,18,19,55,18,15,16,49,34,70,"Yes"
626,"female","White",6,"No",47,"No",13,18,20,51,2,17,13,32,48,76,"No"
243,"female","Native Hawaiian or Other Pacific Islander",8,"Yes",93,"No",16,18,8,42,11,14,18,43,34,89,"Yes"
504,"female","Native Hawaiian or Other Pacific Islander",6,"No",81,"No",11,10,15,36,18,10,14,42,52,57,"No"
708,"male","Black or African American",8,"No",59,"Yes",10,10,19,39,15,11,14,40,80,55,"No"
11,"female","White",6,"Yes",28,"Yes",10,13,18,41,18,17,18,53,28,68,"Yes"
646,"female","Native Hawaiian or Other Pacific Islander",6,"No",49,"Yes",10,14,19,43,16,11,21,48,82,26,"Yes"
968,"female","Native Hawaiian or Other Pacific Islander",7,"Yes",47,"No",14,9,6,29,18,17,16,51,13,48,"No"
834,"female","White",8,"Yes",97,"No",15,11,17,43,10,12,19,41,5,61,"No"
20,"female","Asian",8,"No",90,"Yes",12,11,19,42,18,10,17,45,57,30,"No"
771,"male","White",8,"No",59,"Yes",16,16,13,45,10,8,13,31,40,58,"No"
762,"female","Native Hawaiian or Other Pacific Islander",6,"Yes",89,"Yes",12,8,17,37,10,6,12,28,38,99,"No"
364,"male","American Indian or Alaska Native",6,"No",98,"Yes",17,5,11,33,11,14,19,44,66,94,"No"
60,"female","White",6,"Yes",90,"No",12,5,21,38,15,16,14,45,60,22,"Yes"
511,"female","White",7,"No",17,"No",18,10,15,43,14,14,15,43,66,9,"Yes"
330,"male","White",8,"No",69,"Yes",16,14,19,49,15,8,7,30,4,78,"Yes"
4,"female","American Indian or Alaska Native",8,"No",97,"Yes",12,8,16,36,18,9,10,37,39,87,"Yes"
101,"male","Black or African American",6,"No",96,"No",13,3,21,37,5,16,16,37,94,58,"No"
280,"male","Asian",7,"Yes",52,"No",16,11,9,36,7,4,4,15,14,79,"No"
360,"female","Native Hawaiian or Other Pacific Islander",8,"No",66,"No",13,10,18,41,16,18,13,47,54,94,"No"
598,"female","Native Hawaiian or Other Pacific Islander",6,"No",84,"No",17,14,6,37,15,12,11,38,22,84,"No"
927,"male","Asian",7,"No",88,"No",11,16,15,42,15,18,12,45,2,73,"Yes"
985,"female","American Indian or Alaska Native",8,"No",40,"No",18,17,17,52,14,4,17,35,0,43,"Yes"
244,"female","Native Hawaiian or Other Pacific Islander",7,"Yes",47,"No",5,17,17,39,5,15,13,33,33,62,"Yes"
860,"male","Asian",7,"No",16,"Yes",17,12,14,43,10,7,15,32,55,69,"No"
700,"male","White",8,"No",48,"No",14,16,4,34,14,14,19,47,60,87,"Yes"
214,"male","White",8,"Yes",64,"Yes",12,14,18,44,9,12,16,37,24,30,"No"
257,"male","Asian",8,"Yes",8,"Yes",5,4,7,16,15,15,18,48,15,75,"Yes"
489,"female","Black or African American",7,"Yes",69,"No",13,18,16,47,5,11,18,34,88,84,"Yes"
801,"female","White",6,"Yes",32,"No",12,15,18,45,15,18,15,48,66,37,"No"
456,"male","Asian",6,"No",86,"Yes",15,18,20,53,11,8,12,31,58,59,"No"
518,"male","Native Hawaiian or Other Pacific Islander",6,"No",86,"No",17,15,6,38,18,13,16,47,46,99,"No"
691,"male","Black or African American",7,"Yes",94,"No",2,13,9,24,10,15,5,30,29,61,"Yes"
120,"female","American Indian or Alaska Native",7,"No",68,"No",12,16,19,47,8,18,12,38,73,77,"Yes"
620,"female","Native Hawaiian or Other Pacific Islander",6,"No",49,"Yes",15,6,19,40,2,11,10,23,81,62,"No"
281,"female","Asian",8,"Yes",76,"Yes",15,14,4,33,15,9,19,43,19,25,"Yes"
373,"male","Native Hawaiian or Other Pacific Islander",6,"No",90,"No",12,18,10,40,15,5,2,22,82,41,"No"
648,"female","White",7,"No",97,"Yes",10,5,19,34,3,8,12,23,78,40,"Yes"
976,"female","Asian",8,"No",76,"Yes",8,12,17,37,13,18,8,39,4,100,"No"
508,"male","White",6,"No",65,"Yes",16,17,18,51,18,17,17,52,24,88,"Yes"
425,"male","Native Hawaiian or Other Pacific Islander",6,"Yes",71,"No",11,17,14,42,12,12,12,36,65,32,"Yes"
267,"female","White",7,"Yes",88,"No",10,5,16,31,12,13,4,29,88,15,"Yes"
212,"female","American Indian or Alaska Native",6,"Yes",92,"Yes",6,17,6,29,17,7,16,40,25,75,"Yes"
219,"male","Native Hawaiian or Other Pacific Islander",7,"Yes",63,"No",12,10,20,42,17,5,13,35,35,66,"Yes"
462,"female","American Indian or Alaska Native",7,"Yes",49,"No",13,13,8,34,17,15,21,53,4,71,"No"
825,"male","Asian",7,"Yes",37,"No",16,8,15,39,14,6,20,40,34,19,"Yes"
215,"male","White",8,"No",76,"Yes",14,13,5,32,16,4,12,32,30,80,"Yes"
815,"male","Black or African American",8,"Yes",91,"No",17,12,16,45,15,7,16,38,58,90,"No"
351,"female","Asian",8,"Yes",65,"Yes",17,13,12,42,2,14,21,37,78,35,"No"
495,"male","American Indian or Alaska Native",8,"Yes",81,"Yes",18,14,13,45,13,13,21,47,22,90,"No"
767,"female","Black or African American",6,"No",88,"Yes",4,16,15,35,12,10,12,34,89,92,"No"
113,"male","Black or African American",7,"Yes",69,"Yes",17,16,2,35,15,5,13,33,13,77,"Yes"
525,"female","White",6,"Yes",50,"No",15,14,3,32,16,11,20,47,19,75,"Yes"
862,"male","Asian",6,"Yes",46,"Yes",18,18,8,44,17,12,16,45,86,46,"No"
6,"female","Asian",7,"No",31,"No",11,9,20,40,11,8,4,23,78,18,"No"
770,"female","Asian",7,"No",66,"Yes",12,3,12,27,16,7,4,27,57,55,"Yes"
408,"female","Native Hawaiian or Other Pacific Islander",7,"No",28,"No",15,9,19,43,17,12,21,50,27,90,"No"
977,"female","White",6,"No",89,"No",16,14,7,37,9,6,10,25,11,72,"No"
443,"male","White",8,"Yes",95,"No",14,16,20,50,17,8,15,40,24,44,"Yes"
258,"male","Asian",7,"No",26,"Yes",8,17,6,31,15,16,19,50,21,51,"No"
536,"female","American Indian or Alaska Native",7,"Yes",62,"Yes",16,18,19,53,16,3,20,39,31,42,"Yes"
798,"female","Black or African American",7,"Yes",59,"Yes",14,3,13,30,16,13,21,50,35,13,"No"
856,"male","Black or African American",7,"Yes",52,"Yes",18,8,10,36,15,14,13,42,11,68,"No"
349,"female","Black or African American",6,"No",39,"No",13,11,16,40,15,1,12,28,54,86,"No"
576,"male","American Indian or Alaska Native",8,"No",67,"No",17,17,16,50,15,16,11,42,4,93,"No"
814,"male","American Indian or Alaska Native",7,"Yes",100,"No",16,4,20,40,4,10,18,32,81,61,"No"
158,"female","Black or African American",7,"Yes",68,"No",8,8,21,37,17,15,19,51,3,65,"Yes"
118,"male","White",7,"No",92,"Yes",10,17,13,40,12,12,10,34,91,28,"No"
160,"male","White",7,"No",81,"No",12,12,16,40,17,3,12,32,98,67,"No"
895,"female","White",8,"Yes",82,"No",14,9,20,43,18,6,17,41,0,54,"Yes"
604,"female","Asian",6,"Yes",37,"Yes",13,6,18,37,18,18,12,48,46,47,"Yes"
455,"male","White",6,"Yes",61,"Yes",15,16,11,42,18,3,21,42,66,49,"No"
200,"female","Asian",8,"Yes",63,"No",6,14,20,40,17,18,17,52,46,72,"Yes"
882,"female","Asian",7,"Yes",33,"Yes",14,11,13,38,16,11,14,41,1,59,"No"
663,"male","Native Hawaiian or Other Pacific Islander",8,"Yes",57,"Yes",18,16,16,50,14,1,21,36,95,51,"Yes"
722,"female","Asian",8,"Yes",84,"Yes",16,14,20,50,8,12,13,33,2,87,"No"
188,"male","White",6,"Yes",98,"No",3,17,14,34,17,10,13,40,38,80,"Yes"
650,"female","Native Hawaiian or Other Pacific Islander",7,"No",78,"No",16,7,18,41,10,18,21,49,77,28,"No"
143,"female","Native Hawaiian or Other Pacific Islander",8,"No",27,"No",10,17,11,38,18,18,10,46,19,94,"No"
552,"female","Native Hawaiian or Other Pacific Islander",7,"Yes",86,"Yes",16,7,19,42,13,18,9,40,65,62,"Yes"
675,"male","American Indian or Alaska Native",8,"No",80,"Yes",7,12,13,32,14,18,21,53,54,56,"Yes"
530,"male","Asian",6,"No",25,"Yes",7,18,16,41,8,15,19,42,85,71,"No"
936,"female","Native Hawaiian or Other Pacific Islander",7,"Yes",51,"No",9,13,19,41,16,11,8,35,44,78,"Yes"
424,"female","White",8,"Yes",82,"No",11,1,16,28,17,13,5,35,85,91,"Yes"
547,"female","Native Hawaiian or Other Pacific Islander",8,"No",86,"Yes",6,16,9,31,15,7,19,41,95,66,"Yes"
65,"female","American Indian or Alaska Native",6,"Yes",48,"No",14,17,12,43,9,16,12,37,70,81,"No"
481,"male","White",6,"Yes",60,"No",13,14,21,48,10,18,18,46,34,72,"Yes"
328,"female","Native Hawaiian or Other Pacific Islander",6,"No",99,"Yes",12,4,12,28,15,9,13,37,83,82,"No"
95,"male","Black or African American",7,"No",55,"Yes",13,5,5,23,13,3,17,33,12,85,"No"
611,"male","Asian",8,"Yes",83,"Yes",14,11,20,45,7,9,15,31,59,39,"No"
628,"male","Black or African American",8,"No",91,"Yes",16,16,2,34,8,12,15,35,52,51,"Yes"
48,"female","American Indian or Alaska Native",8,"Yes",66,"No",13,14,20,47,10,12,13,35,79,44,"No"
119,"male","Black or African American",7,"No",55,"Yes",13,15,10,38,2,2,18,22,87,73,"Yes"
329,"male","Black or African American",6,"No",73,"Yes",7,14,13,34,18,16,20,54,52,91,"Yes"
805,"male","American Indian or Alaska Native",6,"No",67,"No",9,4,19,32,10,10,19,39,4,46,"No"
992,"male","Asian",8,"No",34,"No",2,9,19,30,15,11,20,46,71,80,"No"
47,"male","White",7,"No",95,"Yes",14,8,6,28,11,17,16,44,59,51,"Yes"
836,"female","Asian",7,"Yes",90,"No",5,18,16,39,17,11,9,37,22,61,"Yes"
516,"female","White",6,"No",78,"No",5,15,7,27,15,5,18,38,80,45,"No"
262,"female","White",8,"No",79,"Yes",4,3,13,20,4,12,17,33,66,98,"Yes"
361,"female","Asian",7,"No",51,"No",15,18,19,52,14,16,20,50,58,65,"Yes"
630,"female","White",6,"Yes",70,"No",11,14,11,36,10,6,10,26,21,62,"Yes"
5,"male","Asian",6,"No",99,"No",11,18,10,39,18,16,20,54,33,45,"Yes"
45,"female","Black or African American",7,"Yes",50,"Yes",6,17,18,41,16,4,11,31,19,64,"No"
826,"male","Native Hawaiian or Other Pacific Islander",6,"Yes",54,"Yes",5,15,13,33,11,10,21,42,4,72,"No"
745,"male","Asian",6,"Yes",60,"Yes",13,15,16,44,6,11,10,27,16,78,"Yes"
479,"male","Black or African American",6,"No",17,"No",12,9,6,27,16,5,8,29,6,72,"No"
950,"female","Native Hawaiian or Other Pacific Islander",7,"Yes",38,"Yes",9,7,11,27,12,12,8,32,67,52,"Yes"
423,"female","Black or African American",8,"Yes",52,"Yes",18,16,20,54,4,18,20,42,92,79,"Yes"
73,"male","Asian",7,"Yes",41,"Yes",9,11,11,31,15,17,16,48,37,73,"Yes"
796,"male","American Indian or Alaska Native",7,"Yes",75,"No",13,13,13,39,15,1,12,28,42,49,"Yes"
951,"female","Native Hawaiian or Other Pacific Islander",8,"Yes",96,"Yes",11,10,17,38,18,18,9,45,33,23,"No"
468,"female","Asian",7,"No",91,"No",10,17,18,45,10,18,21,49,21,72,"No"
724,"male","American Indian or Alaska Native",8,"Yes",88,"Yes",17,13,12,42,12,10,16,38,11,36,"No"
2,"male","Black or African American",7,"No",89,"Yes",15,6,21,42,15,17,18,50,6,46,"No"
9,"male","American Indian or Alaska Native",7,"No",11,"No",14,7,20,41,3,12,17,32,68,92,"Yes"
703,"female","White",6,"No",33,"Yes",11,18,8,37,8,14,10,32,70,69,"No"
382,"female","White",7,"No",81,"Yes",15,16,15,46,15,10,15,40,5,99,"Yes"
50,"male","American Indian or Alaska Native",6,"No",79,"No",6,13,21,40,12,2,18,32,12,91,"Yes"
193,"female","Asian",7,"Yes",27,"Yes",17,17,19,53,14,2,16,32,79,45,"No"
758,"female","Asian",7,"Yes",78,"No",9,14,10,33,12,12,14,38,3,91,"No"
135,"male","White",7,"Yes",85,"No",13,13,19,45,15,17,17,49,4,40,"Yes"
944,"female","Asian",6,"No",91,"No",7,10,5,22,15,10,21,46,11,53,"Yes"
490,"male","Native Hawaiian or Other Pacific Islander",7,"No",44,"Yes",16,11,14,41,16,18,12,46,65,97,"No"
181,"female","Native Hawaiian or Other Pacific Islander",7,"No",100,"Yes",15,16,2,33,7,11,9,27,92,37,"Yes"
173,"male","Black or African American",8,"Yes",79,"No",14,18,17,49,14,8,21,43,78,99,"No"
928,"male","Native Hawaiian or Other Pacific Islander",8,"No",92,"No",2,18,21,41,13,14,10,37,18,71,"No"
137,"female","White",6,"Yes",77,"Yes",2,12,17,31,11,9,18,38,3,12,"Yes"
809,"female","Asian",7,"Yes",63,"Yes",15,10,17,42,16,18,17,51,54,23,"No"
551,"female","White",8,"No",69,"Yes",6,4,12,22,17,7,10,34,48,66,"No"
692,"female","White",7,"Yes",63,"No",6,15,21,42,12,16,14,42,98,92,"No"
605,"female","Black or African American",6,"No",19,"No",13,17,17,47,14,8,13,35,14,58,"No"
622,"male","Black or African American",8,"No",63,"Yes",16,12,18,46,18,15,13,46,80,80,"Yes"
532,"female","Asian",7,"Yes",36,"No",18,16,20,54,17,14,20,51,3,89,"No"
398,"male","White",8,"No",62,"Yes",14,18,7,39,15,2,16,33,49,53,"Yes"
581,"male","Native Hawaiian or Other Pacific Islander",8,"Yes",97,"Yes",6,13,17,36,16,13,17,46,82,53,"Yes"
99,"female","Native Hawaiian or Other Pacific Islander",8,"No",8,"Yes",16,16,4,36,12,13,10,35,82,77,"Yes"
164,"male","White",8,"Yes",94,"No",17,17,11,45,14,15,11,40,12,88,"No"
470,"female","White",8,"No",87,"No",2,18,19,39,5,15,21,41,53,69,"No"
326,"female","Asian",8,"No",96,"No",17,5,20,42,11,14,7,32,37,44,"Yes"
857,"male","Black or African American",7,"No",91,"Yes",18,12,19,49,12,6,20,38,74,90,"No"
702,"male","American Indian or Alaska Native",7,"Yes",86,"Yes",15,18,11,44,9,11,11,31,87,95,"No"
579,"male","White",6,"Yes",74,"No",18,14,14,46,16,7,17,40,47,49,"Yes"
635,"male","Native Hawaiian or Other Pacific Islander",8,"No",24,"No",18,14,14,46,14,9,19,42,81,99,"Yes"
888,"male","American Indian or Alaska Native",6,"No",91,"Yes",9,16,21,46,16,18,12,46,90,14,"No"
228,"male","White",7,"Yes",34,"No",11,4,20,35,6,18,9,33,59,58,"No"
954,"male","Black or African American",8,"No",83,"Yes",18,10,18,46,15,16,19,50,68,66,"Yes"
921,"female","American Indian or Alaska Native",8,"No",99,"No",13,18,6,37,12,14,12,38,6,85,"Yes"
432,"male","White",6,"No",63,"No",14,15,2,31,10,10,12,32,9,50,"Yes"
705,"male","Native Hawaiian or Other Pacific Islander",7,"Yes",50,"No",13,9,14,36,17,14,14,45,17,75,"No"
197,"female","American Indian or Alaska Native",7,"Yes",95,"Yes",18,5,16,39,15,9,10,34,29,74,"No"
224,"female","Asian",7,"Yes",72,"Yes",9,13,19,41,14,10,13,37,69,92,"No"
829,"male","Asian",6,"No",18,"Yes",9,17,11,37,6,9,5,20,26,93,"No"
569,"female","Native Hawaiian or Other Pacific Islander",6,"Yes",74,"No",14,6,20,40,15,17,6,38,32,75,"Yes"
368,"female","Black or African American",8,"No",88,"No",13,15,17,45,17,13,14,44,49,87,"No"
546,"male","White",7,"Yes",79,"No",18,11,21,50,15,18,21,54,89,89,"No"
467,"male","Black or African American",7,"No",35,"Yes",8,7,13,28,17,15,17,49,16,95,"Yes"
463,"male","White",7,"Yes",52,"Yes",9,2,21,32,13,16,14,43,3,100,"No"
252,"female","American Indian or Alaska Native",7,"Yes",91,"Yes",17,13,11,41,12,18,21,51,95,99,"No"
908,"female","White",6,"Yes",88,"Yes",15,15,18,48,16,18,13,47,25,48,"Yes"
254,"female","Native Hawaiian or Other Pacific Islander",7,"Yes",39,"Yes",16,14,14,44,18,10,14,42,10,50,"Yes"
896,"male","White",8,"No",94,"No",16,15,7,38,9,12,21,42,71,78,"Yes"
475,"male","American Indian or Alaska Native",6,"Yes",80,"Yes",13,12,17,42,16,2,12,30,65,19,"No"
661,"male","White",8,"No",93,"Yes",7,14,16,37,11,16,19,46,98,66,"No"
736,"female","Black or African American",7,"Yes",95,"Yes",15,15,16,46,17,17,4,38,67,69,"Yes"
793,"female","White",8,"No",63,"Yes",15,15,20,50,6,17,16,39,48,87,"No"
279,"male","Black or African American",6,"No",41,"No",12,9,15,36,17,13,20,50,66,83,"No"
42,"female","Asian",6,"Yes",75,"Yes",17,10,21,48,12,17,20,49,92,92,"No"
457,"male","Native Hawaiian or Other Pacific Islander",8,"No",47,"No",12,15,20,47,17,10,17,44,33,35,"No"
269,"female","White",6,"No",99,"Yes",9,16,14,39,6,12,16,34,35,84,"Yes"
625,"male","Black or African American",7,"No",85,"Yes",12,15,6,33,13,18,21,52,21,76,"No"
846,"male","American Indian or Alaska Native",7,"Yes",84,"No",15,13,14,42,18,13,19,50,67,81,"No"
29,"female","Native Hawaiian or Other Pacific Islander",7,"Yes",100,"No",15,11,3,29,9,17,15,41,74,93,"No"
606,"male","American Indian or Alaska Native",8,"Yes",62,"Yes",13,11,15,39,10,8,16,34,78,61,"Yes"
879,"male","White",7,"Yes",99,"Yes",10,9,14,33,15,5,18,38,0,57,"Yes"
261,"male","White",8,"Yes",58,"Yes",12,11,12,35,10,18,13,41,17,34,"No"
238,"female","American Indian or Alaska Native",6,"Yes",77,"No",12,13,9,34,15,7,17,39,32,79,"No"
919,"female","American Indian or Alaska Native",8,"No",49,"No",12,15,18,45,4,10,15,29,6,91,"No"
838,"male","Native Hawaiian or Other Pacific Islander",7,"No",77,"Yes",14,14,2,30,15,16,7,38,83,61,"No"
656,"female","Black or African American",7,"Yes",94,"Yes",10,15,12,37,4,18,17,39,52,98,"No"
54,"male","White",8,"Yes",89,"Yes",3,12,17,32,8,14,8,30,26,93,"No"
79,"female","American Indian or Alaska Native",8,"No",88,"No",4,4,13,21,14,8,20,42,86,87,"Yes"
385,"male","Native Hawaiian or Other Pacific Islander",7,"No",19,"No",14,15,10,39,14,14,16,44,75,55,"Yes"
595,"male","American Indian or Alaska Native",8,"Yes",85,"Yes",18,7,21,46,17,13,5,35,61,91,"No"
603,"male","Black or African American",8,"No",69,"No",15,17,20,52,18,8,21,47,47,66,"No"
236,"female","Native Hawaiian or Other Pacific Islander",7,"No",81,"No",9,17,17,43,3,10,10,23,46,92,"No"
85,"female","Asian",7,"Yes",18,"No",14,11,14,39,16,10,17,43,81,10,"No"
899,"male","Native Hawaiian or Other Pacific Islander",8,"Yes",98,"No",12,15,6,33,17,10,14,41,59,62,"Yes"
402,"female","Native Hawaiian or Other Pacific Islander",7,"No",70,"Yes",10,11,21,42,8,3,21,32,78,43,"No"
677,"male","American Indian or Alaska Native",7,"No",33,"No",17,8,21,46,7,12,12,31,16,41,"Yes"
52,"male","American Indian or Alaska Native",7,"Yes",67,"No",7,18,9,34,4,12,19,35,62,72,"No"
206,"female","White",6,"No",86,"Yes",12,14,15,41,11,9,19,39,64,51,"Yes"
643,"male","Native Hawaiian or Other Pacific Islander",7,"Yes",85,"Yes",11,18,15,44,12,15,9,36,30,59,"Yes"
130,"female","Black or African American",7,"Yes",17,"Yes",18,8,15,41,18,7,13,38,39,91,"No"
325,"female","Native Hawaiian or Other Pacific Islander",8,"Yes",60,"No",5,8,9,22,9,17,19,45,60,41,"No"
144,"male","White",8,"Yes",47,"No",18,7,20,45,4,18,9,31,66,69,"No"
71,"male","Asian",8,"No",64,"Yes",8,18,14,40,10,17,6,33,46,53,"Yes"
80,"male","White",7,"Yes",84,"Yes",16,18,21,55,11,1,4,16,36,88,"Yes"
875,"female","Black or African American",6,"No",68,"Yes",17,14,19,50,16,10,11,37,80,59,"No"
223,"female","American Indian or Alaska Native",8,"Yes",80,"No",18,18,18,54,7,15,5,27,77,94,"No"
121,"female","Asian",7,"No",85,"No",18,16,12,46,18,14,18,50,80,54,"Yes"
226,"female","Native Hawaiian or Other Pacific Islander",7,"No",87,"No",1,14,11,26,13,15,18,46,90,49,"Yes"
565,"male","Native Hawaiian or Other Pacific Islander",8,"No",35,"Yes",14,10,15,39,14,2,12,28,9,46,"Yes"
684,"male","American Indian or Alaska Native",6,"No",96,"Yes",15,9,17,41,18,13,17,48,55,33,"No"
707,"male","Native Hawaiian or Other Pacific Islander",6,"No",81,"No",16,17,18,51,18,13,13,44,69,30,"No"
660,"female","Black or African American",7,"No",93,"Yes",6,12,20,38,12,3,13,28,90,78,"Yes"
789,"male","Asian",7,"No",12,"No",10,13,20,43,12,7,1,20,36,90,"No"
515,"male","White",8,"No",34,"No",13,18,7,38,16,10,12,38,6,61,"Yes"
502,"female","Native Hawaiian or Other Pacific Islander",6,"No",68,"No",15,11,6,32,11,16,9,36,11,45,"Yes"
292,"male","Native Hawaiian or Other Pacific Islander",6,"No",66,"Yes",3,13,16,32,15,12,20,47,76,24,"No"
961,"male","Black or African American",8,"No",29,"Yes",14,13,13,40,17,9,21,47,79,100,"Yes"
929,"male","American Indian or Alaska Native",6,"No",50,"Yes",18,12,10,40,16,11,21,48,45,53,"No"
828,"male","Black or African American",6,"Yes",81,"No",15,16,15,46,5,10,21,36,27,96,"Yes"
990,"female","Asian",8,"No",64,"Yes",16,12,15,43,17,16,20,53,34,70,"No"
202,"male","Asian",7,"No",22,"Yes",12,17,6,35,15,17,2,34,20,54,"No"
994,"male","Native Hawaiian or Other Pacific Islander",7,"No",90,"Yes",17,17,9,43,15,14,5,34,60,76,"Yes"
559,"male","Native Hawaiian or Other Pacific Islander",7,"Yes",88,"Yes",9,10,17,36,16,17,7,40,15,84,"No"
33,"male","American Indian or Alaska Native",6,"No",98,"Yes",11,6,21,38,8,17,9,34,1,96,"Yes"
422,"female","White",7,"No",81,"Yes",17,14,19,50,12,13,21,46,40,86,"No"
627,"female","Asian",7,"No",57,"Yes",8,14,11,33,16,12,6,34,61,97,"Yes"
911,"male","American Indian or Alaska Native",8,"No",91,"Yes",8,14,10,32,13,14,12,39,53,56,"No"
619,"female","White",6,"Yes",63,"No",5,14,19,38,10,13,7,30,20,98,"No"
46,"female","Native Hawaiian or Other Pacific Islander",6,"Yes",75,"Yes",11,6,19,36,17,16,19,52,40,98,"No"
185,"female","Black or African American",7,"Yes",71,"No",9,8,13,30,9,15,13,37,12,22,"No"
469,"female","Asian",6,"No",67,"Yes",17,3,20,40,18,17,6,41,55,60,"No"
687,"male","American Indian or Alaska Native",6,"No",64,"No",14,10,14,38,14,9,14,37,55,45,"Yes"
848,"female","Native Hawaiian or Other Pacific Islander",7,"Yes",52,"No",18,16,5,39,16,17,15,48,91,53,"No"
26,"female","White",6,"No",53,"No",17,8,14,39,11,18,19,48,86,70,"No"
963,"female","Native Hawaiian or Other Pacific Islander",6,"No",49,"No",17,14,8,39,13,18,16,47,48,63,"No"
464,"female","White",6,"No",12,"Yes",17,9,6,32,10,14,18,42,25,97,"Yes"
109,"male","Native Hawaiian or Other Pacific Islander",6,"Yes",74,"No",13,16,16,45,12,15,15,42,8,78,"No"
777,"male","American Indian or Alaska Native",6,"No",46,"No",14,11,12,37,16,15,19,50,74,56,"No"
988,"male","Asian",7,"Yes",38,"No",14,8,15,37,5,15,17,37,54,50,"No"
931,"female","Native Hawaiian or Other Pacific Islander",7,"Yes",95,"Yes",17,17,11,45,17,15,16,48,76,77,"No"
981,"female","Black or African American",8,"No",86,"No",13,18,6,37,12,11,5,28,49,93,"No"
884,"female","Native Hawaiian or Other Pacific Islander",8,"No",75,"No",11,18,3,32,15,4,9,28,96,68,"No"
459,"male","American Indian or Alaska Native",8,"Yes",50,"Yes",5,16,13,34,13,16,10,39,20,80,"No"
585,"female","White",7,"Yes",62,"Yes",2,8,6,16,18,7,21,46,73,92,"Yes"
582,"female","Native Hawaiian or Other Pacific Islander",6,"Yes",72,"Yes",14,9,16,39,10,6,18,34,64,49,"Yes"
51,"female","American Indian or Alaska Native",6,"Yes",44,"No",7,7,20,34,17,18,10,45,66,68,"Yes"
303,"female","Native Hawaiian or Other Pacific Islander",7,"No",33,"No",18,9,21,48,5,4,13,22,86,33,"Yes"
317,"male","Asian",7,"No",69,"No",9,16,14,39,13,11,17,41,19,32,"No"
434,"male","Black or African American",6,"Yes",80,"Yes",18,9,10,37,4,4,21,29,64,45,"Yes"
140,"female","American Indian or Alaska Native",6,"No",24,"No",12,15,15,42,13,15,17,45,18,67,"No"
522,"female","Black or African American",7,"No",97,"No",7,18,17,42,17,2,11,30,73,75,"Yes"
446,"female","Native Hawaiian or Other Pacific Islander",8,"Yes",75,"No",16,13,3,32,16,16,10,42,60,42,"No"
399,"male","Black or African American",7,"No",84,"No",1,10,16,27,11,15,21,47,6,83,"No"
88,"female","Asian",7,"Yes",32,"No",10,10,16,36,10,15,9,34,37,64,"Yes"
920,"female","Black or African American",8,"No",35,"No",13,9,15,37,8,9,13,30,28,79,"No"
438,"male","Native Hawaiian or Other Pacific Islander",6,"No",92,"No",1,18,14,33,13,8,19,40,26,18,"Yes"
18,"female","Asian",7,"No",60,"No",14,18,19,51,15,18,13,46,22,51,"Yes"
865,"female","White",6,"Yes",87,"Yes",10,17,11,38,15,15,7,37,12,89,"Yes"
613,"female","Asian",8,"No",53,"No",14,12,14,40,18,13,5,36,46,83,"No"
589,"male","Native Hawaiian or Other Pacific Islander",8,"Yes",81,"No",9,4,11,24,6,10,18,34,62,81,"No"
632,"female","Native Hawaiian or Other Pacific Islander",6,"No",52,"Yes",13,11,18,42,16,14,18,48,66,47,"Yes"
778,"male","American Indian or Alaska Native",7,"Yes",84,"No",8,11,21,40,18,14,19,51,15,95,"No"
433,"male","Native Hawaiian or Other Pacific Islander",6,"Yes",55,"Yes",18,13,20,51,17,6,16,39,86,67,"Yes"
785,"male","American Indian or Alaska Native",7,"No",7,"Yes",11,18,12,41,13,7,20,40,45,15,"Yes"
393,"female","Asian",7,"No",74,"Yes",8,15,21,44,16,6,13,35,71,32,"No"
763,"female","Asian",8,"No",40,"Yes",15,3,11,29,5,12,17,34,93,89,"No"
505,"male","White",7,"No",99,"Yes",14,18,3,35,13,12,20,45,24,72,"No"
344,"male","Native Hawaiian or Other Pacific Islander",8,"No",98,"Yes",15,18,19,52,3,16,19,38,12,54,"Yes"
68,"female","Asian",6,"No",89,"Yes",3,16,11,30,13,7,18,38,97,80,"No"
392,"male","American Indian or Alaska Native",6,"Yes",55,"Yes",18,18,20,56,18,13,21,52,100,74,"No"
615,"female","Asian",8,"No",59,"No",9,18,9,36,16,14,7,37,54,38,"Yes"
774,"female","Native Hawaiian or Other Pacific Islander",8,"Yes",76,"Yes",18,9,18,45,13,7,21,41,85,71,"No"
345,"female","American Indian or Alaska Native",8,"Yes",71,"No",15,7,19,41,18,8,3,29,55,77,"Yes"
693,"female","Native Hawaiian or Other Pacific Islander",8,"No",73,"Yes",11,18,14,43,7,9,20,36,31,59,"No"
493,"female","Asian",8,"Yes",57,"No",16,17,19,52,14,8,13,35,5,57,"No"
543,"male","American Indian or Alaska Native",6,"No",84,"Yes",18,8,19,45,9,9,7,25,79,59,"Yes"
318,"female","Asian",6,"Yes",85,"No",13,8,15,36,15,12,11,38,19,24,"Yes"
437,"female","White",7,"No",76,"No",2,18,14,34,1,9,21,31,55,67,"Yes"
266,"male","American Indian or Alaska Native",7,"Yes",63,"No",14,12,12,38,14,9,9,32,17,78,"Yes"
616,"male","Native Hawaiian or Other Pacific Islander",7,"No",51,"Yes",15,17,9,41,16,12,3,31,8,70,"No"
304,"female","Asian",8,"No",20,"No",18,4,8,30,18,15,12,45,85,82,"Yes"
124,"female","Black or African American",7,"Yes",69,"Yes",8,14,6,28,11,18,19,48,47,78,"Yes"
421,"male","American Indian or Alaska Native",6,"Yes",98,"No",3,11,19,33,9,18,18,45,45,98,"Yes"
527,"male","Asian",6,"No",61,"Yes",18,16,18,52,18,17,10,45,87,42,"Yes"
114,"female","Black or African American",8,"Yes",34,"No",15,13,15,43,7,14,8,29,19,11,"No"
666,"male","White",6,"Yes",100,"No",8,10,3,21,9,18,19,46,19,84,"No"
127,"male","White",8,"No",67,"Yes",6,13,20,39,6,16,9,31,22,43,"No"
671,"male","American Indian or Alaska Native",6,"No",43,"Yes",17,13,7,37,14,6,7,27,61,72,"Yes"
871,"male","Black or African American",7,"Yes",83,"Yes",15,16,7,38,14,16,10,40,99,42,"No"
248,"male","Black or African American",8,"No",70,"Yes",10,9,3,22,8,15,18,41,74,72,"Yes"
655,"male","Native Hawaiian or Other Pacific Islander",8,"No",57,"No",13,12,14,39,8,15,16,39,77,73,"Yes"
420,"female","White",8,"Yes",43,"No",8,17,21,46,14,11,12,37,25,89,"No"
997,"male","Native Hawaiian or Other Pacific Islander",7,"No",54,"Yes",14,15,14,43,12,15,21,48,33,54,"No"
445,"female","Asian",6,"Yes",69,"No",13,18,13,44,18,12,15,45,28,83,"No"
282,"male","Black or African American",6,"Yes",41,"No",10,14,9,33,13,5,7,25,10,46,"No"
550,"female","American Indian or Alaska Native",8,"Yes",49,"Yes",10,15,21,46,1,11,18,30,93,97,"Yes"
291,"male","Native Hawaiian or Other Pacific Islander",8,"Yes",66,"No",9,17,20,46,18,14,18,50,32,88,"Yes"
749,"male","Native Hawaiian or Other Pacific Islander",6,"No",33,"Yes",18,11,6,35,9,15,17,41,69,60,"Yes"
698,"female","White",6,"No",97,"No",14,16,18,48,14,12,21,47,86,67,"No"
612,"male","Native Hawaiian or Other Pacific Islander",7,"No",86,"Yes",11,18,19,48,8,14,16,38,34,42,"Yes"
676,"male","White",8,"Yes",32,"Yes",7,14,16,37,8,9,8,25,31,55,"Yes"
125,"male","White",8,"Yes",78,"Yes",13,17,15,45,10,11,17,38,3,48,"Yes"
854,"female","White",8,"No",100,"Yes",17,6,21,44,17,13,18,48,29,46,"Yes"
53,"female","Black or African American",6,"No",10,"Yes",17,9,14,40,17,3,10,30,27,35,"No"
593,"male","American Indian or Alaska Native",6,"Yes",84,"No",11,10,13,34,10,18,2,30,24,59,"No"
363,"female","White",8,"No",87,"No",3,18,17,38,15,16,21,52,57,86,"No"
379,"male","Asian",7,"No",37,"No",16,17,21,54,15,11,21,47,40,88,"Yes"
850,"male","American Indian or Alaska Native",8,"Yes",65,"Yes",13,13,19,45,11,15,1,27,60,90,"Yes"
720,"female","White",7,"Yes",91,"Yes",17,4,14,35,15,14,20,49,46,63,"No"
22,"female","American Indian or Alaska Native",6,"Yes",84,"Yes",18,16,16,50,18,14,20,52,64,92,"No"
863,"female","Native Hawaiian or Other Pacific Islander",7,"Yes",26,"Yes",15,9,12,36,16,6,19,41,35,86,"No"
624,"female","Black or African American",8,"No",50,"Yes",14,4,12,30,9,9,15,33,58,32,"No"
494,"male","Asian",8,"No",91,"No",15,13,12,40,3,17,20,40,23,90,"Yes"
70,"male","White",7,"Yes",71,"No",18,9,19,46,4,17,19,40,51,95,"Yes"
740,"male","White",7,"No",92,"Yes",7,17,12,36,7,11,21,39,13,64,"No"
926,"female","Native Hawaiian or Other Pacific Islander",8,"No",100,"Yes",8,16,9,33,17,14,18,49,89,78,"Yes"
713,"female","Native Hawaiian or Other Pacific Islander",6,"No",48,"No",12,12,18,42,7,5,14,26,40,7,"Yes"
91,"male","White",8,"No",32,"Yes",13,14,18,45,16,1,9,26,48,97,"Yes"
430,"female","Asian",6,"Yes",48,"Yes",15,18,19,52,17,6,16,39,56,14,"No"
667,"male","White",6,"No",52,"Yes",18,16,13,47,18,18,21,57,44,46,"No"
979,"male","American Indian or Alaska Native",7,"No",71,"Yes",10,13,13,36,13,8,21,42,65,65,"No"
563,"male","Asian",8,"Yes",48,"Yes",16,14,14,44,9,18,10,37,88,64,"No"
390,"male","American Indian or Alaska Native",8,"Yes",59,"No",18,17,19,54,13,14,16,43,74,96,"No"
614,"female","American Indian or Alaska Native",7,"No",62,"Yes",15,6,20,41,10,16,21,47,5,100,"Yes"
946,"female","American Indian or Alaska Native",6,"Yes",78,"No",5,12,18,35,5,8,16,29,9,88,"Yes"
447,"male","Native Hawaiian or Other Pacific Islander",6,"No",87,"No",10,13,16,39,16,17,21,54,26,90,"No"
198,"male","White",6,"Yes",52,"No",11,6,17,34,12,14,21,47,86,67,"Yes"
183,"female","Native Hawaiian or Other Pacific Islander",8,"No",26,"No",14,3,18,35,10,14,17,41,14,23,"Yes"
285,"female","American Indian or Alaska Native",6,"No",93,"No",16,16,16,48,15,11,14,40,37,88,"No"
548,"male","Black or African American",7,"No",89,"Yes",8,13,3,24,16,17,21,54,55,95,"No"
629,"female","Black or African American",6,"No",88,"No",9,9,12,30,8,5,16,29,44,79,"No"
886,"male","Asian",7,"Yes",63,"No",17,10,14,41,13,15,5,33,19,54,"No"
513,"female","American Indian or Alaska Native",8,"No",59,"Yes",16,18,6,40,11,18,18,47,59,24,"Yes"
973,"male","Black or African American",6,"No",46,"Yes",8,17,3,28,17,17,15,49,27,68,"No"
414,"male","Black or African American",7,"No",64,"Yes",18,10,13,41,15,16,17,48,28,89,"No"
410,"male","Asian",8,"No",48,"No",16,7,20,43,18,10,16,44,76,90,"Yes"
800,"female","Black or African American",6,"Yes",23,"Yes",12,14,18,44,9,9,19,37,15,34,"Yes"
773,"male","American Indian or Alaska Native",7,"Yes",91,"Yes",18,14,13,45,17,12,21,50,38,97,"No"
186,"female","Asian",8,"Yes",94,"Yes",10,17,13,40,14,12,6,32,5,54,"No"
84,"female","White",7,"Yes",66,"No",13,17,18,48,18,12,19,49,0,74,"Yes"
573,"female","Asian",8,"No",84,"No",13,18,12,43,12,9,14,35,19,57,"Yes"
841,"female","White",7,"No",50,"No",17,18,6,41,17,12,20,49,24,72,"Yes"
933,"female","White",8,"No",51,"No",12,12,9,33,11,13,19,43,60,46,"Yes"
574,"male","American Indian or Alaska Native",6,"No",82,"Yes",9,16,4,29,15,14,11,40,63,70,"No"
742,"male","Black or African American",8,"Yes",99,"No",17,9,4,30,7,15,17,39,9,24,"No"
746,"male","Asian",7,"Yes",57,"Yes",5,18,14,37,18,8,19,45,69,65,"No"
782,"female","American Indian or Alaska Native",6,"Yes",35,"No",14,16,10,40,18,14,19,51,68,52,"Yes"
19,"male","American Indian or Alaska Native",6,"Yes",63,"Yes",14,17,20,51,8,9,15,32,19,99,"Yes"
937,"female","Black or African American",8,"Yes",90,"No",13,15,11,39,12,18,17,47,78,55,"No"
833,"female","American Indian or Alaska Native",6,"Yes",95,"No",11,11,12,34,14,17,13,44,65,82,"No"
893,"female","American Indian or Alaska Native",6,"No",67,"No",18,17,17,52,8,18,21,47,34,74,"Yes"
644,"male","Asian",8,"No",22,"Yes",17,7,16,40,8,8,19,35,9,64,"No"
31,"male","Asian",7,"Yes",50,"Yes",15,18,14,47,15,13,21,49,75,75,"Yes"
567,"female","American Indian or Alaska Native",6,"No",97,"No",18,13,13,44,15,18,1,34,21,49,"No"
405,"male","Black or African American",6,"Yes",98,"No",16,18,18,52,9,13,18,40,31,48,"No"
451,"male","Asian",8,"Yes",42,"No",8,9,6,23,16,7,9,32,37,57,"Yes"
517,"female","Native Hawaiian or Other Pacific Islander",8,"Yes",99,"No",15,17,15,47,18,6,10,34,97,85,"Yes"
971,"male","Asian",7,"Yes",66,"No",3,13,16,32,16,18,16,50,74,54,"Yes"
103,"male","Native Hawaiian or Other Pacific Islander",6,"No",31,"Yes",8,16,21,45,8,16,14,38,12,87,"No"
128,"female","White",6,"No",68,"Yes",18,3,7,28,13,18,14,45,49,95,"Yes"
350,"male","White",7,"No",58,"Yes",17,17,9,43,12,17,21,50,83,66,"Yes"
394,"female","White",7,"Yes",67,"No",18,10,7,35,16,12,21,49,91,51,"No"
233,"female","Asian",6,"Yes",67,"No",14,15,9,38,18,7,12,37,92,89,"No"
98,"male","Native Hawaiian or Other Pacific Islander",8,"No",84,"No",17,9,17,43,17,15,13,45,26,51,"Yes"
37,"male","Native Hawaiian or Other Pacific Islander",8,"Yes",83,"Yes",12,13,21,46,16,16,17,49,18,94,"No"
86,"female","Asian",7,"Yes",12,"Yes",18,15,10,43,8,14,11,33,21,98,"Yes"
239,"male","White",8,"No",56,"No",16,14,2,32,13,13,13,39,55,34,"Yes"
66,"male","Black or African American",6,"No",47,"Yes",16,16,16,48,5,13,11,29,9,28,"No"
986,"male","Asian",6,"Yes",32,"Yes",13,8,11,32,13,12,17,42,34,73,"Yes"
25,"male","American Indian or Alaska Native",7,"Yes",38,"Yes",14,16,16,46,7,15,19,41,40,63,"Yes"
316,"male","White",6,"No",49,"Yes",17,9,19,45,16,15,15,46,76,23,"No"
58,"male","Native Hawaiian or Other Pacific Islander",8,"No",42,"No",3,17,20,40,13,10,12,35,92,47,"No"
162,"male","White",6,"Yes",77,"No",11,13,21,45,9,9,10,28,74,95,"No"
923,"male","Asian",8,"No",21,"Yes",16,17,11,44,7,12,19,38,17,41,"No"
806,"male","White",6,"Yes",95,"Yes",18,14,10,42,9,11,13,33,62,39,"Yes"
497,"male","American Indian or Alaska Native",8,"No",20,"No",17,18,12,47,15,16,11,42,69,78,"Yes"
415,"male","Native Hawaiian or Other Pacific Islander",8,"Yes",93,"Yes",9,17,9,35,15,4,21,40,35,56,"No"
715,"female","American Indian or Alaska Native",7,"No",76,"No",18,10,12,40,15,17,15,47,51,95,"Yes"
77,"male","Black or African American",6,"Yes",65,"No",11,17,16,44,17,7,12,36,24,11,"Yes"
621,"female","Native Hawaiian or Other Pacific Islander",8,"Yes",37,"No",14,12,10,36,13,17,13,43,68,94,"No"
790,"male","Black or African American",6,"No",98,"No",17,8,17,42,17,16,8,41,71,94,"No"
30,"male","American Indian or Alaska Native",6,"No",89,"No",15,10,18,43,9,10,15,34,28,76,"No"
664,"male","Asian",6,"No",96,"No",9,3,15,27,5,12,16,33,79,50,"No"
450,"male","White",8,"Yes",100,"No",10,12,20,42,9,18,13,40,62,61,"No"
64,"male","Asian",7,"No",73,"No",17,18,8,43,12,9,17,38,17,82,"No"
315,"female","Asian",6,"No",55,"No",16,14,16,46,14,7,13,34,20,27,"Yes"
670,"female","White",6,"No",44,"No",17,18,11,46,18,14,16,48,80,72,"Yes"
312,"male","White",6,"No",36,"Yes",5,8,8,21,15,2,20,37,26,47,"No"
196,"male","American Indian or Alaska Native",7,"No",87,"Yes",16,5,8,29,9,12,13,34,56,46,"Yes"
220,"male","Native Hawaiian or Other Pacific Islander",8,"Yes",83,"Yes",11,5,20,36,7,12,16,35,34,55,"Yes"
904,"male","American Indian or Alaska Native",6,"No",58,"Yes",17,5,21,43,9,16,10,35,55,38,"No"
642,"male","Asian",8,"Yes",70,"No",16,1,10,27,16,17,17,50,74,71,"No"
358,"female","White",7,"Yes",19,"No",7,14,10,31,15,18,18,51,12,95,"Yes"
428,"male","Native Hawaiian or Other Pacific Islander",6,"No",100,"Yes",15,9,10,34,17,15,13,45,48,95,"Yes"
268,"female","Native Hawaiian or Other Pacific Islander",7,"Yes",71,"Yes",9,15,18,42,12,18,16,46,26,29,"Yes"
313,"male","American Indian or Alaska Native",7,"Yes",68,"Yes",12,17,12,41,15,13,1,29,59,33,"Yes"
178,"male","Native Hawaiian or Other Pacific Islander",6,"Yes",84,"No",13,7,14,34,12,17,18,47,49,77,"No"
835,"female","White",8,"No",81,"No",15,13,17,45,11,10,15,36,73,64,"No"
989,"female","Asian",8,"No",90,"No",18,10,4,32,14,14,18,46,17,62,"No"
647,"male","Black or African American",6,"Yes",45,"Yes",12,1,21,34,7,9,10,26,87,75,"No"
512,"male","Asian",6,"No",96,"Yes",8,10,21,39,11,14,11,36,64,73,"No"
444,"female","Native Hawaiian or Other Pacific Islander",8,"Yes",37,"Yes",11,16,18,45,18,8,11,37,29,94,"Yes"
678,"male","White",8,"Yes",88,"Yes",16,12,17,45,12,16,20,48,86,90,"No"
639,"female","Black or African American",6,"No",95,"No",12,13,10,35,18,9,20,47,10,34,"Yes"
894,"female","Native Hawaiian or Other Pacific Islander",8,"Yes",96,"Yes",17,10,18,45,17,11,14,42,39,66,"No"
945,"male","Native Hawaiian or Other Pacific Islander",7,"Yes",99,"No",8,12,21,41,13,16,20,49,88,94,"No"
492,"male","Native Hawaiian or Other Pacific Islander",8,"No",78,"Yes",12,7,21,40,11,1,10,22,44,12,"Yes"
830,"male","White",8,"No",95,"Yes",3,8,16,27,14,15,17,46,18,69,"Yes"
348,"male","American Indian or Alaska Native",6,"No",44,"Yes",14,18,12,44,16,6,16,38,58,95,"No"
191,"female","Native Hawaiian or Other Pacific Islander",8,"Yes",54,"Yes",18,5,14,37,7,16,13,36,29,84,"No"
412,"female","Asian",8,"Yes",81,"No",10,11,8,29,15,15,15,45,18,66,"Yes"
991,"female","White",8,"No",75,"No",17,12,19,48,11,14,20,45,65,32,"No"
82,"male","White",7,"No",25,"No",7,17,20,44,12,9,19,40,8,64,"Yes"
419,"female","Native Hawaiian or Other Pacific Islander",7,"Yes",80,"Yes",3,2,12,17,18,17,8,43,10,97,"Yes"
734,"female","Black or African American",6,"No",57,"No",6,13,8,27,15,18,20,53,4,77,"No"
797,"male","Black or African American",6,"No",62,"Yes",16,17,18,51,8,2,18,28,78,58,"No"
94,"male","Black or African American",6,"Yes",34,"No",16,11,20,47,10,4,10,24,25,98,"Yes"
837,"male","White",8,"No",56,"No",17,11,19,47,7,9,16,32,73,93,"Yes"
194,"female","White",7,"Yes",52,"No",2,8,12,22,17,17,20,54,95,56,"Yes"
458,"female","Asian",7,"Yes",100,"Yes",7,15,18,40,17,17,8,42,28,89,"Yes"
633,"female","White",7,"No",57,"No",11,15,9,35,13,16,9,38,67,94,"Yes"
877,"female","Native Hawaiian or Other Pacific Islander",8,"No",83,"No",14,5,9,28,9,11,21,41,62,96,"No"
227,"female","Native Hawaiian or Other Pacific Islander",7,"No",92,"Yes",12,15,19,46,7,6,19,32,27,87,"No"
395,"female","White",6,"Yes",88,"No",7,4,17,28,6,17,19,42,25,77,"Yes"
537,"male","Black or African American",8,"Yes",56,"No",10,6,19,35,11,16,19,46,65,56,"No"
880,"male","American Indian or Alaska Native",6,"Yes",55,"Yes",8,14,17,39,15,12,14,41,52,84,"Yes"
208,"female","White",7,"No",61,"No",2,18,20,40,11,12,15,38,25,52,"Yes"
386,"female","American Indian or Alaska Native",6,"No",35,"No",18,18,13,49,17,18,2,37,60,74,"No"
786,"male","Native Hawaiian or Other Pacific Islander",8,"Yes",78,"Yes",5,17,17,39,17,10,19,46,31,94,"No"
704,"female","Black or African American",7,"No",64,"No",13,10,16,39,6,13,12,31,22,88,"Yes"
17,"female","Black or African American",7,"No",34,"No",15,8,21,44,5,16,10,31,28,81,"Yes"
519,"male","Black or African American",6,"No",58,"No",12,15,6,33,5,17,5,27,50,4,"Yes"
148,"female","American Indian or Alaska Native",6,"Yes",77,"No",3,5,19,27,13,10,9,32,16,79,"Yes"
761,"female","Native Hawaiian or Other Pacific Islander",7,"No",98,"Yes",17,16,21,54,14,15,20,49,71,89,"Yes"
235,"female","Native Hawaiian or Other Pacific Islander",6,"No",96,"Yes",12,11,21,44,6,7,8,21,28,63,"No"
637,"male","Native Hawaiian or Other Pacific Islander",6,"Yes",48,"Yes",14,16,17,47,17,14,21,52,79,84,"No"
858,"female","White",8,"Yes",89,"Yes",16,8,11,35,18,8,14,40,79,47,"No"
739,"male","Asian",8,"No",29,"Yes",15,4,21,40,14,11,15,40,8,42,"No"
452,"female","White",6,"No",62,"No",15,9,21,45,18,18,10,46,18,96,"No"
640,"female","White",6,"No",81,"Yes",11,18,7,36,18,13,17,48,37,43,"No"
426,"male","Native Hawaiian or Other Pacific Islander",6,"No",90,"Yes",16,9,16,41,10,4,4,18,87,45,"No"
769,"female","Asian",7,"Yes",71,"Yes",16,9,13,38,12,17,10,39,31,92,"Yes"
726,"female","Black or African American",6,"No",92,"Yes",4,14,9,27,9,7,8,24,1,25,"No"
154,"male","Asian",7,"No",46,"Yes",13,4,20,37,11,17,11,39,38,79,"Yes"
887,"female","White",7,"No",90,"Yes",16,10,12,38,3,18,21,42,35,24,"No"
596,"male","Black or African American",7,"Yes",67,"No",14,16,14,44,16,11,14,41,24,54,"Yes"
250,"female","American Indian or Alaska Native",7,"Yes",11,"No",17,16,10,43,18,13,19,50,47,48,"No"
356,"female","Asian",8,"No",88,"No",13,18,16,47,17,13,9,39,4,99,"No"
554,"male","American Indian or Alaska Native",8,"Yes",87,"No",10,10,14,34,8,10,16,34,52,99,"Yes"
531,"female","Asian",7,"No",48,"Yes",13,15,21,49,13,7,13,33,85,55,"No"
234,"male","Black or African American",6,"No",100,"Yes",8,11,18,37,8,16,17,41,38,31,"No"
906,"male","American Indian or Alaska Native",8,"Yes",87,"Yes",15,15,15,45,16,9,19,44,49,76,"No"
682,"male","Native Hawaiian or Other Pacific Islander",7,"No",75,"Yes",18,10,18,46,18,14,11,43,57,53,"No"
247,"male","American Indian or Alaska Native",6,"Yes",56,"No",15,16,5,36,13,12,7,32,98,48,"Yes"
847,"male","Black or African American",7,"No",97,"Yes",15,16,15,46,10,16,17,43,70,72,"No"
209,"female","White",7,"No",94,"No",13,12,13,38,10,14,7,31,37,81,"No"
541,"male","White",7,"Yes",36,"No",13,16,21,50,10,13,13,36,7,66,"No"
932,"male","American Indian or Alaska Native",6,"No",41,"No",7,1,20,28,18,17,18,53,42,75,"Yes"
314,"male","Asian",8,"No",85,"No",14,16,19,49,12,18,20,50,88,87,"Yes"
1000,"male","American Indian or Alaska Native",7,"Yes",80,"Yes",16,6,14,36,14,7,3,24,51,45,"No"
112,"female","White",6,"No",29,"Yes",9,9,18,36,18,14,19,51,94,46,"No"
298,"male","Asian",6,"Yes",94,"Yes",10,4,20,34,6,18,17,41,58,74,"No"
866,"male","American Indian or Alaska Native",7,"No",80,"Yes",17,10,7,34,8,4,19,31,22,83,"No"
970,"female","White",8,"No",89,"No",15,12,14,41,9,17,19,45,14,80,"Yes"
12,"male","Black or African American",8,"No",75,"Yes",15,10,17,42,13,1,7,21,80,75,"Yes"
272,"male","Black or African American",7,"Yes",48,"No",9,12,20,41,16,17,21,54,72,54,"No"
912,"female","White",6,"No",55,"Yes",15,14,17,46,15,14,8,37,75,61,"No"
8,"female","White",7,"Yes",66,"No",3,17,18,38,16,10,19,45,43,95,"No"
353,"male","American Indian or Alaska Native",6,"Yes",40,"Yes",14,4,16,34,10,13,15,38,85,28,"No"
617,"male","Asian",6,"Yes",100,"Yes",18,11,17,46,4,15,14,33,19,85,"Yes"
108,"female","American Indian or Alaska Native",8,"No",87,"Yes",18,17,15,50,1,18,20,39,76,92,"No"
67,"male","White",6,"Yes",40,"Yes",18,17,17,52,18,16,21,55,60,80,"Yes"
199,"male","American Indian or Alaska Native",7,"No",99,"Yes",8,18,15,41,15,17,7,39,87,89,"No"
881,"female","Native Hawaiian or Other Pacific Islander",6,"Yes",44,"No",12,11,17,40,11,14,12,37,65,68,"No"
876,"female","White",8,"Yes",61,"Yes",18,15,10,43,14,5,15,34,50,60,"Yes"
249,"male","American Indian or Alaska Native",8,"No",90,"No",15,13,20,48,17,15,17,49,35,46,"No"
403,"female","Asian",7,"No",59,"Yes",3,12,17,32,5,18,20,43,100,82,"Yes"
74,"male","Black or African American",7,"No",60,"No",13,7,13,33,13,9,21,43,66,89,"No"
766,"male","Asian",7,"Yes",85,"No",13,11,10,34,16,18,19,53,80,56,"No"
336,"male","White",6,"Yes",96,"No",15,9,21,45,17,9,14,40,82,61,"No"
491,"male","American Indian or Alaska Native",6,"Yes",70,"Yes",13,3,13,29,6,18,19,43,61,21,"No"
859,"male","Black or African American",7,"No",54,"No",10,11,17,38,3,14,16,33,52,95,"Yes"
529,"female","American Indian or Alaska Native",8,"No",88,"Yes",14,16,15,45,18,17,18,53,58,62,"Yes"
914,"male","American Indian or Alaska Native",8,"No",79,"No",15,10,8,33,16,14,21,51,5,90,"No"
897,"female","Asian",8,"Yes",100,"Yes",17,7,10,34,7,17,21,45,80,77,"No"
204,"male","American Indian or Alaska Native",6,"No",57,"No",11,14,20,45,14,18,19,51,35,95,"Yes"
901,"female","American Indian or Alaska Native",6,"No",84,"Yes",14,6,17,37,12,18,19,49,22,61,"No"
170,"male","Native Hawaiian or Other Pacific Islander",7,"No",85,"No",13,7,15,35,8,18,7,33,26,47,"Yes"
500,"female","Black or African American",6,"Yes",24,"No",12,17,20,49,12,9,20,41,10,28,"No"
788,"female","Native Hawaiian or Other Pacific Islander",7,"No",75,"Yes",5,16,21,42,15,12,21,48,5,47,"Yes"
171,"male","Asian",8,"No",28,"No",18,15,16,49,11,9,5,25,11,97,"No"
649,"male","American Indian or Alaska Native",7,"No",95,"Yes",12,15,17,44,16,14,14,44,51,68,"Yes"
93,"female","Native Hawaiian or Other Pacific Islander",6,"No",64,"Yes",7,12,10,29,16,7,9,32,84,60,"No"
207,"male","Native Hawaiian or Other Pacific Islander",7,"Yes",96,"Yes",12,11,13,36,15,6,2,23,78,99,"No"
96,"female","White",8,"No",98,"Yes",12,9,17,38,17,4,13,34,78,92,"Yes"
571,"male","Asian",7,"Yes",83,"Yes",18,17,12,47,15,17,14,46,20,97,"Yes"
416,"male","White",6,"No",58,"No",4,12,13,29,15,2,13,30,40,97,"Yes"
725,"male","White",7,"No",55,"No",14,4,17,35,9,15,14,38,15,67,"No"
156,"male","White",7,"No",56,"No",13,14,19,46,8,16,16,40,21,21,"No"
845,"male","Native Hawaiian or Other Pacific Islander",8,"Yes",45,"No",18,11,16,45,18,17,5,40,31,57,"Yes"
597,"male","Black or African American",8,"No",69,"No",7,14,10,31,17,7,19,43,68,65,"No"
264,"female","Native Hawaiian or Other Pacific Islander",7,"No",67,"No",13,14,8,35,18,4,18,40,63,95,"Yes"
743,"male","White",8,"Yes",67,"No",10,15,18,43,18,11,14,43,53,96,"No"
853,"male","Black or African American",6,"No",82,"Yes",17,17,20,54,15,13,12,40,1,69,"Yes"
808,"male","White",8,"Yes",68,"No",10,6,16,32,3,12,9,24,51,68,"Yes"
436,"male","Native Hawaiian or Other Pacific Islander",6,"No",33,"No",15,15,6,36,12,7,18,37,91,43,"Yes"
288,"male","Native Hawaiian or Other Pacific Islander",8,"Yes",75,"No",14,13,6,33,16,16,21,53,59,81,"Yes"
804,"male","American Indian or Alaska Native",8,"No",72,"No",12,8,6,26,6,8,19,33,26,100,"Yes"
885,"male","Black or African American",7,"No",80,"Yes",11,18,18,47,13,9,20,42,1,76,"Yes"
631,"female","White",6,"Yes",42,"Yes",18,16,2,36,11,8,17,36,34,53,"Yes"
159,"male","Native Hawaiian or Other Pacific Islander",7,"Yes",96,"Yes",16,5,8,29,14,13,17,44,77,96,"No"
192,"female","Black or African American",7,"Yes",31,"Yes",13,17,21,51,17,7,20,44,90,91,"Yes"
701,"female","White",6,"Yes",85,"No",9,17,18,44,5,10,11,26,56,48,"No"
943,"female","Black or African American",6,"Yes",92,"No",14,9,21,44,10,14,15,39,44,49,"Yes"
391,"female","Asian",8,"No",91,"No",14,17,21,52,14,13,8,35,65,62,"No"
259,"male","White",7,"No",92,"Yes",5,12,12,29,14,17,17,48,78,98,"No"
827,"female","Black or African American",8,"Yes",92,"Yes",11,9,19,39,14,17,11,42,7,80,"No"
967,"female","White",8,"No",94,"Yes",9,16,9,34,14,13,11,38,68,65,"Yes"
507,"male","Asian",8,"No",77,"No",14,11,20,45,11,17,21,49,95,73,"No"
482,"female","White",8,"No",94,"No",16,17,12,45,11,6,19,36,11,95,"No"
274,"female","White",8,"Yes",100,"No",16,18,13,47,17,12,15,44,5,100,"No"
867,"female","American Indian or Alaska Native",6,"Yes",88,"Yes",8,17,17,42,17,14,13,44,16,93,"No"
369,"male","Native Hawaiian or Other Pacific Islander",8,"No",38,"Yes",17,15,8,40,17,18,19,54,33,23,"Yes"
540,"female","Black or African American",6,"Yes",51,"Yes",7,15,9,31,14,11,14,39,4,20,"Yes"
448,"male","Asian",7,"No",97,"Yes",18,16,13,47,17,15,21,53,20,32,"No"
510,"female","Native Hawaiian or Other Pacific Islander",7,"Yes",100,"No",17,7,21,45,6,13,1,20,98,75,"Yes"
566,"female","Asian",7,"Yes",65,"Yes",12,17,18,47,18,11,21,50,63,66,"Yes"
934,"male","White",6,"No",94,"Yes",14,11,18,43,14,12,10,36,30,63,"No"
533,"female","White",6,"Yes",99,"No",16,15,19,50,8,7,15,30,99,70,"Yes"
123,"female","Black or African American",6,"No",71,"No",11,7,13,31,15,16,19,50,34,82,"Yes"
768,"male","White",6,"Yes",45,"No",12,18,20,50,15,17,8,40,65,97,"No"
925,"male","Asian",7,"Yes",45,"Yes",3,9,19,31,18,10,21,49,25,86,"No"
177,"male","American Indian or Alaska Native",6,"No",32,"No",11,17,15,43,18,10,9,37,31,93,"No"
695,"female","American Indian or Alaska Native",7,"No",57,"No",11,12,18,41,18,18,14,50,48,38,"No"
712,"male","Asian",8,"Yes",25,"Yes",12,16,19,47,2,18,17,37,45,76,"Yes"
744,"male","Asian",6,"No",36,"Yes",14,15,21,50,18,5,20,43,51,50,"No"
601,"male","American Indian or Alaska Native",8,"Yes",65,"Yes",17,16,4,37,8,12,15,35,4,74,"No"
295,"female","American Indian or Alaska Native",6,"No",69,"No",4,9,11,24,17,9,18,44,8,65,"No"
913,"male","Black or African American",7,"No",97,"Yes",16,13,21,50,16,11,14,41,17,72,"Yes"
210,"female","Black or African American",8,"No",87,"Yes",16,11,13,40,14,7,13,34,57,41,"Yes"
301,"female","Black or African American",8,"Yes",76,"No",13,17,12,42,9,18,17,44,97,97,"Yes"
710,"female","Asian",8,"Yes",83,"Yes",9,11,20,40,11,10,18,39,80,100,"Yes"
780,"female","Black or African American",8,"No",75,"Yes",17,18,12,47,15,14,17,46,65,62,"Yes"
558,"male","Native Hawaiian or Other Pacific Islander",7,"Yes",87,"Yes",17,14,21,52,17,13,6,36,35,99,"Yes"
201,"female","White",8,"Yes",96,"No",14,7,21,42,9,8,15,32,14,26,"Yes"
383,"male","Black or African American",6,"Yes",92,"No",6,10,21,37,4,1,18,23,84,59,"No"
488,"female","American Indian or Alaska Native",8,"Yes",64,"Yes",8,12,15,35,16,16,18,50,6,50,"Yes"
460,"male","Native Hawaiian or Other Pacific Islander",7,"Yes",41,"No",17,13,18,48,15,13,19,47,9,88,"No"
429,"female","American Indian or Alaska Native",6,"Yes",24,"No",17,9,17,43,8,13,21,42,1,69,"Yes"
138,"female","Native Hawaiian or Other Pacific Islander",8,"Yes",62,"No",15,17,12,44,15,16,16,47,34,40,"Yes"
179,"male","White",7,"Yes",95,"No",9,16,13,38,18,17,19,54,47,89,"Yes"
300,"female","Asian",7,"No",63,"No",15,16,21,52,13,10,14,37,15,94,"No"
714,"female","Asian",6,"Yes",58,"Yes",14,10,12,36,15,17,11,43,77,35,"No"
813,"female","Native Hawaiian or Other Pacific Islander",8,"No",85,"Yes",15,15,6,36,18,16,19,53,46,87,"Yes"
190,"female","American Indian or Alaska Native",7,"Yes",83,"Yes",3,17,18,38,17,17,11,45,29,93,"No"
924,"female","Asian",7,"Yes",79,"No",17,11,13,41,11,14,17,42,80,99,"No"
56,"male","Black or African American",8,"Yes",32,"No",5,16,17,38,4,1,2,7,27,40,"Yes"
555,"female","Asian",8,"Yes",69,"No",12,7,16,35,8,13,10,31,41,98,"Yes"
376,"male","American Indian or Alaska Native",6,"Yes",20,"No",14,18,21,53,16,14,17,47,70,37,"No"
15,"male","Asian",8,"Yes",99,"Yes",10,10,19,39,8,12,14,34,58,46,"Yes"
506,"male","Black or African American",7,"No",90,"No",13,7,2,22,13,8,6,27,7,74,"Yes"
38,"male","Native Hawaiian or Other Pacific Islander",7,"Yes",76,"No",12,10,12,34,7,17,19,43,90,48,"No"
807,"female","American Indian or Alaska Native",6,"No",99,"Yes",15,13,13,41,16,7,19,42,75,65,"No"
242,"male","Native Hawaiian or Other Pacific Islander",8,"No",29,"Yes",18,17,15,50,7,16,21,44,44,88,"Yes"
564,"female","Black or African American",6,"No",71,"No",12,17,9,38,8,10,12,30,54,88,"No"
958,"male","White",7,"Yes",52,"Yes",12,18,17,47,15,16,4,35,74,98,"Yes"
39,"female","White",6,"Yes",96,"No",16,11,5,32,17,14,15,46,66,91,"No"
172,"male","White",7,"Yes",68,"Yes",16,18,12,46,14,7,10,31,18,92,"No"
672,"female","White",6,"No",42,"No",4,17,14,35,15,4,17,36,76,45,"Yes"
132,"female","Asian",8,"No",75,"Yes",17,8,16,41,5,16,20,41,78,76,"Yes"
980,"female","American Indian or Alaska Native",8,"No",35,"Yes",16,7,11,34,5,16,19,40,61,49,"No"
539,"female","White",8,"No",85,"No",17,12,20,49,13,4,9,26,25,49,"No"
290,"male","Asian",6,"No",63,"No",17,16,11,44,18,5,19,42,39,54,"No"
340,"male","Black or African American",8,"No",94,"No",15,13,18,46,13,8,21,42,66,59,"Yes"
129,"female","Asian",8,"No",99,"Yes",9,5,1,15,8,16,17,41,93,91,"No"
256,"female","Native Hawaiian or Other Pacific Islander",6,"Yes",21,"Yes",15,18,18,51,16,15,21,52,58,24,"No"
756,"female","American Indian or Alaska Native",8,"Yes",97,"Yes",10,15,20,45,13,17,19,49,27,80,"No"
34,"female","White",8,"Yes",90,"No",1,17,12,30,11,13,7,31,55,63,"No"
189,"male","Native Hawaiian or Other Pacific Islander",6,"Yes",76,"No",11,17,15,43,17,14,18,49,46,85,"Yes"
654,"female","American Indian or Alaska Native",7,"Yes",96,"Yes",18,17,12,47,18,18,19,55,85,75,"Yes"
417,"female","American Indian or Alaska Native",6,"Yes",51,"Yes",12,13,5,30,16,10,21,47,78,83,"Yes"
993,"male","Native Hawaiian or Other Pacific Islander",8,"No",73,"Yes",4,16,18,38,14,16,21,51,31,94,"No"
959,"male","Native Hawaiian or Other Pacific Islander",7,"No",73,"Yes",9,16,12,37,18,3,18,39,24,54,"No"
599,"male","American Indian or Alaska Native",7,"Yes",62,"Yes",6,18,15,39,14,1,20,35,69,23,"Yes"
878,"female","White",8,"No",92,"No",6,6,11,23,11,11,18,40,88,89,"Yes"
449,"female","White",6,"Yes",85,"No",13,7,17,37,1,18,16,35,7,54,"No"
122,"female","White",8,"No",43,"No",15,15,21,51,11,17,20,48,28,37,"No"
289,"male","Asian",7,"Yes",37,"Yes",7,15,17,39,13,18,19,50,42,75,"Yes"
890,"male","Asian",8,"No",19,"No",16,16,6,38,13,7,21,41,67,91,"Yes"
523,"male","White",8,"Yes",100,"Yes",1,12,6,19,14,15,19,48,60,97,"No"
665,"female","Asian",8,"No",85,"No",9,17,21,47,15,15,12,42,63,27,"Yes"
975,"female","Black or African American",6,"No",78,"No",11,12,18,41,11,14,11,36,9,60,"Yes"
240,"male","White",6,"No",76,"Yes",17,13,6,36,14,4,18,36,72,59,"No"
466,"male","Asian",6,"Yes",57,"No",10,9,9,28,12,8,10,30,3,85,"Yes"
592,"male","Native Hawaiian or Other Pacific Islander",7,"Yes",93,"No",1,10,21,32,15,9,19,43,60,68,"No"
157,"male","Asian",8,"No",96,"No",13,17,11,41,2,18,9,29,71,62,"No"
63,"male","American Indian or Alaska Native",6,"Yes",22,"No",15,11,21,47,11,18,10,39,82,83,"Yes"
275,"female","Asian",8,"No",73,"No",4,15,18,37,12,15,13,40,14,47,"Yes"
147,"female","Native Hawaiian or Other Pacific Islander",8,"No",86,"No",18,14,10,42,15,17,4,36,26,51,"Yes"
568,"male","Asian",7,"Yes",84,"Yes",13,18,1,32,8,16,14,38,19,83,"Yes"
87,"female","Asian",7,"Yes",76,"Yes",5,2,9,16,12,15,15,42,92,86,"No"
802,"female","Native Hawaiian or Other Pacific Islander",6,"Yes",35,"Yes",16,16,17,49,15,10,19,44,98,92,"No"
600,"male","Asian",8,"No",68,"Yes",18,11,13,42,13,13,14,40,71,61,"No"
842,"female","White",7,"No",91,"Yes",16,8,11,35,17,13,15,45,54,66,"No"
230,"male","Asian",7,"No",97,"Yes",7,15,5,27,8,6,18,32,27,88,"Yes"
355,"female","Asian",6,"Yes",71,"Yes",15,18,17,50,16,17,2,35,46,31,"No"
729,"female","White",6,"No",83,"No",8,16,18,42,16,12,10,38,15,79,"Yes"
775,"male","Asian",6,"Yes",47,"Yes",11,8,19,38,12,10,21,43,32,75,"No"
14,"female","White",6,"Yes",76,"Yes",2,18,10,30,10,4,14,28,84,76,"No"
757,"female","Black or African American",6,"Yes",75,"No",16,10,10,36,17,4,10,31,35,83,"Yes"
270,"male","Asian",8,"Yes",85,"No",7,14,14,35,7,18,12,37,77,72,"Yes"
883,"female","White",6,"No",80,"No",4,18,9,31,18,9,16,43,71,64,"Yes"
251,"male","American Indian or Alaska Native",6,"Yes",71,"No",16,13,13,42,6,11,15,32,4,96,"No"
217,"female","Black or African American",8,"Yes",81,"No",3,13,15,31,11,13,20,44,91,84,"No"
245,"female","Black or African American",6,"Yes",90,"Yes",13,9,15,37,16,16,18,50,39,58,"Yes"
341,"male","Native Hawaiian or Other Pacific Islander",8,"Yes",39,"Yes",18,16,12,46,4,15,18,37,16,48,"Yes"
874,"female","White",8,"Yes",80,"No",14,10,12,36,14,11,14,39,77,26,"Yes"
984,"male","Black or African American",6,"Yes",24,"No",12,4,11,27,6,16,11,33,53,84,"No"
184,"male","Native Hawaiian or Other Pacific Islander",6,"No",62,"No",13,12,15,40,9,3,21,33,34,37,"Yes"
795,"male","American Indian or Alaska Native",8,"No",84,"Yes",18,15,17,50,1,15,20,36,25,83,"Yes"
136,"male","White",7,"Yes",89,"No",17,14,8,39,8,14,11,33,16,91,"No"
231,"male","Asian",6,"No",34,"No",9,15,8,32,13,5,4,22,78,49,"Yes"
59,"male","Native Hawaiian or Other Pacific Islander",8,"No",24,"No",13,16,18,47,11,14,16,41,31,84,"Yes"
476,"male","American Indian or Alaska Native",7,"No",32,"Yes",15,12,19,46,16,9,21,46,48,93,"No"
354,"male","Asian",7,"No",68,"Yes",15,13,7,35,5,4,18,27,82,41,"No"
983,"male","Native Hawaiian or Other Pacific Islander",6,"No",81,"No",6,16,21,43,12,13,21,46,26,72,"No"
23,"female","White",6,"Yes",99,"Yes",13,14,18,45,6,16,20,42,3,86,"Yes"
792,"male","White",8,"Yes",63,"No",18,11,14,43,6,18,5,29,35,29,"Yes"
337,"female","Black or African American",8,"No",57,"Yes",16,18,16,50,12,13,11,36,44,99,"Yes"
310,"male","American Indian or Alaska Native",7,"Yes",64,"No",17,16,5,38,9,14,21,44,91,40,"Yes"
960,"male","American Indian or Alaska Native",7,"No",62,"No",18,3,14,35,16,17,11,44,58,90,"Yes"
485,"male","Asian",6,"Yes",96,"No",12,5,19,36,11,16,15,42,71,79,"Yes"
941,"male","White",7,"No",30,"No",17,15,17,49,9,13,16,38,21,79,"Yes"
840,"male","White",7,"Yes",100,"No",17,17,7,41,18,5,17,40,29,95,"No"
900,"female","Black or African American",7,"Yes",61,"No",15,18,14,47,6,11,21,38,36,57,"Yes"
917,"male","Black or African American",6,"Yes",68,"No",17,8,15,40,17,14,12,43,67,41,"Yes"
133,"male","Asian",7,"Yes",98,"Yes",16,10,19,45,16,14,14,44,8,24,"Yes"
323,"female","American Indian or Alaska Native",6,"No",80,"Yes",11,13,19,43,15,18,19,52,45,96,"Yes"
347,"male","White",6,"No",73,"Yes",9,10,19,38,16,17,19,52,52,36,"Yes"
175,"male","Black or African American",7,"Yes",96,"No",11,16,16,43,3,15,21,39,59,63,"Yes"
864,"female","Native Hawaiian or Other Pacific Islander",8,"Yes",76,"Yes",15,14,18,47,13,7,18,38,81,91,"No"
791,"female","Asian",7,"Yes",65,"No",15,18,12,45,17,13,15,45,35,74,"Yes"
534,"male","Native Hawaiian or Other Pacific Islander",7,"Yes",39,"No",16,13,20,49,10,16,11,37,51,95,"Yes"
514,"female","White",7,"No",63,"No",14,10,8,32,5,16,17,38,57,79,"Yes"
107,"male","Asian",7,"Yes",99,"No",18,17,17,52,12,9,20,41,12,99,"No"
441,"male","White",7,"Yes",79,"No",11,17,15,43,13,17,15,45,35,15,"Yes"
166,"male","American Indian or Alaska Native",6,"Yes",83,"No",15,5,11,31,14,16,17,47,22,25,"No"
824,"male","American Indian or Alaska Native",7,"Yes",86,"Yes",11,11,2,24,9,16,14,39,5,31,"No"
538,"female","Asian",7,"Yes",77,"No",5,10,6,21,12,4,16,32,24,83,"Yes"
342,"male","Black or African American",6,"No",67,"Yes",15,15,17,47,10,11,13,34,42,96,"Yes"
699,"male","Asian",8,"No",10,"Yes",12,17,15,44,18,7,16,41,3,25,"No"
371,"female","White",8,"Yes",85,"No",5,12,6,23,10,12,17,39,89,95,"Yes"
83,"male","American Indian or Alaska Native",6,"Yes",10,"Yes",11,10,12,33,17,13,15,45,97,70,"Yes"
689,"female","American Indian or Alaska Native",8,"Yes",29,"Yes",15,17,20,52,15,10,20,45,70,100,"Yes"
803,"female","Native Hawaiian or Other Pacific Islander",8,"No",83,"Yes",17,13,15,45,14,14,7,35,48,72,"Yes"
286,"female","American Indian or Alaska Native",7,"No",72,"Yes",17,5,10,32,15,8,16,39,82,45,"Yes"
263,"male","American Indian or Alaska Native",6,"No",87,"Yes",2,12,16,30,16,5,21,42,59,62,"No"
241,"male","Asian",8,"Yes",58,"No",9,10,12,31,11,10,20,41,44,60,"No"
659,"male","American Indian or Alaska Native",8,"No",67,"Yes",13,16,18,47,16,18,20,54,92,22,"No"
176,"female","Native Hawaiian or Other Pacific Islander",7,"Yes",99,"No",17,18,17,52,13,9,18,40,53,54,"No"
92,"male","Asian",8,"Yes",64,"No",9,10,10,29,10,18,21,49,95,39,"No"
276,"female","American Indian or Alaska Native",8,"Yes",30,"Yes",3,16,11,30,13,10,16,39,77,80,"No"
591,"male","White",7,"No",71,"Yes",8,10,14,32,11,17,17,45,42,61,"Yes"
501,"male","White",6,"No",99,"No",18,15,5,38,10,9,16,35,75,74,"No"
499,"female","White",7,"Yes",10,"Yes",8,13,14,35,13,10,16,39,97,97,"No"
168,"male","American Indian or Alaska Native",8,"No",37,"No",9,15,20,44,9,18,11,38,6,17,"No"
453,"female","Black or African American",8,"Yes",85,"No",13,17,13,43,11,14,16,41,79,93,"No"
150,"male","American Indian or Alaska Native",7,"Yes",57,"No",14,2,16,32,15,10,21,46,24,8,"Yes"
709,"female","White",8,"No",82,"Yes",14,16,17,47,16,10,7,33,35,97,"No"
3,"male","Asian",6,"Yes",64,"Yes",18,11,11,40,15,13,12,40,44,43,"No"
810,"male","Native Hawaiian or Other Pacific Islander",6,"No",24,"No",13,15,9,37,1,14,9,24,66,54,"Yes"
389,"male","Black or African American",8,"No",34,"Yes",15,4,14,33,17,10,13,40,46,46,"Yes"
776,"male","Black or African American",7,"No",75,"Yes",4,17,9,30,4,11,16,31,73,92,"Yes"
953,"female","American Indian or Alaska Native",6,"No",80,"No",6,13,17,36,12,14,16,42,84,50,"Yes"
741,"male","American Indian or Alaska Native",7,"Yes",89,"No",11,6,7,24,18,11,14,43,97,32,"Yes"
697,"male","White",8,"Yes",67,"No",18,10,19,47,11,18,16,45,95,87,"Yes"
852,"female","Black or African American",6,"No",96,"Yes",15,11,19,45,10,16,8,34,27,88,"No"
151,"male","American Indian or Alaska Native",7,"Yes",99,"No",9,18,18,45,17,6,20,43,91,19,"No"
41,"male","Asian",6,"Yes",78,"No",16,13,12,41,15,12,11,38,51,34,"No"
203,"male","Native Hawaiian or Other Pacific Islander",8,"No",59,"No",1,16,9,26,14,12,18,44,6,84,"Yes"
43,"female","Black or African American",7,"Yes",85,"No",8,2,21,31,11,18,6,35,72,72,"No"
380,"female","American Indian or Alaska Native",8,"Yes",94,"No",8,17,16,41,17,16,20,53,51,37,"No"
309,"male","Native Hawaiian or Other Pacific Islander",6,"No",93,"Yes",14,14,7,35,14,18,8,40,84,81,"No"
474,"male","White",7,"Yes",47,"Yes",18,17,21,56,8,10,17,35,4,45,"No"
297,"male","White",7,"Yes",69,"Yes",9,12,5,26,14,12,17,43,77,56,"No"
759,"male","Asian",7,"No",95,"No",13,4,21,38,14,10,18,42,2,41,"No"
956,"male","Black or African American",7,"No",91,"Yes",15,17,19,51,14,4,7,25,46,31,"Yes"
211,"female","Asian",7,"No",48,"No",17,15,19,51,3,6,10,19,67,87,"No"
587,"male","Asian",6,"Yes",64,"Yes",15,11,6,32,2,14,17,33,75,87,"No"
723,"male","Black or African American",8,"No",94,"Yes",10,13,7,30,16,17,18,51,91,68,"No"
21,"female","White",6,"Yes",85,"Yes",3,17,8,28,14,15,21,50,24,50,"Yes"
738,"male","American Indian or Alaska Native",7,"Yes",94,"No",16,14,15,45,16,14,19,49,56,32,"Yes"
126,"male","Native Hawaiian or Other Pacific Islander",8,"Yes",81,"No",9,16,20,45,13,8,19,40,90,85,"No"
750,"male","Asian",8,"No",97,"No",12,14,13,39,18,16,11,45,1,61,"Yes"
89,"female","White",6,"No",17,"No",4,6,4,14,16,14,15,45,48,87,"No"
213,"female","White",7,"No",83,"Yes",11,17,8,36,10,14,18,42,6,62,"No"
719,"female","White",8,"No",46,"No",13,18,12,43,11,15,13,39,83,53,"Yes"
359,"male","Asian",8,"Yes",53,"Yes",8,12,14,34,17,9,4,30,9,91,"Yes"
167,"male","Native Hawaiian or Other Pacific Islander",6,"No",66,"No",15,16,11,42,17,8,5,30,93,17,"Yes"
367,"female","Native Hawaiian or Other Pacific Islander",7,"No",93,"Yes",10,9,10,29,11,12,13,36,42,96,"Yes"
535,"male","White",6,"Yes",70,"No",18,14,12,44,16,18,20,54,80,73,"No"
869,"female","White",6,"Yes",58,"Yes",18,3,15,36,10,14,14,38,15,68,"No"
396,"male","Native Hawaiian or Other Pacific Islander",6,"No",50,"No",13,16,16,45,4,15,21,40,6,86,"Yes"
962,"male","White",7,"Yes",99,"Yes",8,4,12,24,14,14,15,43,96,88,"No"
873,"female","Native Hawaiian or Other Pacific Islander",8,"No",12,"Yes",17,18,5,40,13,14,10,37,82,81,"No"
378,"female","American Indian or Alaska Native",8,"No",70,"Yes",18,12,12,42,14,6,17,37,82,96,"No"
765,"female","Asian",6,"Yes",74,"Yes",10,11,10,31,15,16,19,50,7,68,"No"
819,"male","Native Hawaiian or Other Pacific Islander",7,"Yes",62,"No",17,14,19,50,18,5,15,38,63,37,"Yes"
498,"male","Black or African American",6,"No",29,"Yes",7,17,20,44,10,16,14,40,45,71,"Yes"
717,"male","American Indian or Alaska Native",8,"Yes",22,"Yes",9,12,14,35,18,12,12,42,69,87,"No"
465,"male","American Indian or Alaska Native",6,"Yes",49,"Yes",14,4,17,35,15,8,9,32,1,94,"Yes"
496,"female","American Indian or Alaska Native",7,"Yes",53,"No",18,5,11,34,9,7,18,34,88,61,"No"
764,"female","American Indian or Alaska Native",8,"Yes",94,"No",18,12,14,44,13,13,19,45,90,31,"Yes"
372,"male","Asian",6,"No",63,"Yes",13,18,17,48,9,18,6,33,5,20,"No"
849,"male","Black or African American",8,"Yes",48,"No",13,13,11,37,16,16,15,47,95,48,"No"
781,"male","White",6,"Yes",74,"No",13,13,21,47,15,8,6,29,97,48,"Yes"
964,"male","White",6,"No",49,"No",18,16,20,54,16,10,16,42,14,63,"No"
947,"male","Native Hawaiian or Other Pacific Islander",8,"No",74,"Yes",13,10,11,34,11,17,7,35,44,47,"No"
753,"female","American Indian or Alaska Native",7,"Yes",98,"No",2,12,20,34,15,18,15,48,42,84,"Yes"
524,"male","Native Hawaiian or Other Pacific Islander",8,"No",45,"Yes",12,11,16,39,13,14,15,42,48,98,"No"
339,"female","Native Hawaiian or Other Pacific Islander",8,"No",68,"Yes",5,16,11,32,7,17,9,33,27,50,"No"
696,"male","American Indian or Alaska Native",6,"Yes",61,"Yes",17,15,19,51,14,17,16,47,1,61,"Yes"
222,"female","Black or African American",7,"Yes",76,"No",18,18,8,44,11,12,19,42,6,73,"Yes"
580,"female","Native Hawaiian or Other Pacific Islander",6,"No",34,"No",18,5,12,35,5,7,6,18,65,82,"No"
503,"female","Native Hawaiian or Other Pacific Islander",6,"Yes",70,"Yes",11,13,11,35,17,12,13,42,3,37,"No"
784,"female","Asian",8,"Yes",58,"Yes",11,16,6,33,9,6,21,36,51,56,"Yes"
218,"female","Native Hawaiian or Other Pacific Islander",6,"No",93,"No",14,17,2,33,12,18,16,46,6,56,"No"
787,"male","American Indian or Alaska Native",8,"No",97,"No",13,7,20,40,10,12,21,43,91,98,"No"
673,"female","Native Hawaiian or Other Pacific Islander",7,"No",80,"Yes",5,17,14,36,18,15,10,43,36,65,"Yes"
370,"female","Native Hawaiian or Other Pacific Islander",6,"No",60,"Yes",15,9,17,41,16,12,13,41,60,73,"Yes"
375,"male","White",6,"No",78,"No",2,17,17,36,7,18,10,35,7,41,"No"
440,"male","American Indian or Alaska Native",8,"No",82,"No",17,18,16,51,15,15,13,43,42,51,"Yes"
321,"female","American Indian or Alaska Native",7,"Yes",31,"Yes",17,15,17,49,18,17,20,55,64,75,"No"
570,"female","American Indian or Alaska Native",6,"No",37,"No",5,14,21,40,14,17,16,47,89,63,"No"
706,"male","White",6,"Yes",69,"Yes",3,17,7,27,16,17,21,54,48,91,"Yes"
55,"female","Native Hawaiian or Other Pacific Islander",6,"No",20,"No",17,18,14,49,12,4,9,25,98,75,"Yes"
346,"female","Asian",7,"Yes",90,"Yes",12,12,17,41,11,12,14,37,2,65,"No"
609,"female","Native Hawaiian or Other Pacific Islander",7,"No",94,"No",11,7,2,20,11,10,16,37,73,57,"Yes"
28,"female","Native Hawaiian or Other Pacific Islander",8,"Yes",66,"No",5,18,18,41,15,17,4,36,24,30,"Yes"
668,"male","White",8,"Yes",92,"Yes",10,12,15,37,18,16,15,49,69,96,"Yes"
816,"male","Black or African American",7,"No",68,"Yes",15,7,17,39,8,17,16,41,56,52,"No"
0,"male","Native Hawaiian or Other Pacific Islander",7,"No",45,"No",12,12,8,32,18,18,7,43,43,28,"Yes"
851,"female","Asian",7,"Yes",87,"Yes",13,2,19,34,13,10,18,41,84,92,"No"
942,"female","American Indian or Alaska Native",7,"No",67,"Yes",15,11,16,42,13,7,17,37,66,85,"Yes"
229,"female","White",7,"No",66,"No",13,2,5,20,15,18,16,49,72,98,"Yes"
253,"female","American Indian or Alaska Native",6,"Yes",21,"Yes",6,14,4,24,18,12,19,49,23,66,"No"
384,"female","Black or African American",8,"No",85,"No",17,18,20,55,18,6,20,44,94,60,"No"
174,"female","White",8,"No",93,"Yes",15,6,20,41,14,8,3,25,66,98,"No"
509,"female","White",7,"Yes",55,"Yes",10,18,20,48,15,18,17,50,97,69,"Yes"
216,"female","Asian",8,"No",52,"Yes",10,10,7,27,15,10,19,44,7,49,"Yes"
747,"male","Asian",7,"Yes",99,"Yes",18,17,19,54,7,13,17,37,60,91,"Yes"
844,"male","Black or African American",6,"No",55,"Yes",15,8,13,36,3,8,15,26,40,46,"Yes"
545,"male","White",6,"No",11,"No",5,15,10,30,14,9,19,42,53,15,"No"
955,"male","Black or African American",8,"Yes",79,"No",17,16,9,42,9,18,7,34,51,44,"No"
716,"male","American Indian or Alaska Native",8,"No",44,"No",16,12,20,48,12,13,19,44,22,51,"Yes"
602,"male","White",8,"No",92,"Yes",8,8,13,29,11,13,13,37,57,88,"No"
760,"female","Native Hawaiian or Other Pacific Islander",8,"No",63,"Yes",13,18,17,48,13,8,18,39,8,64,"Yes"
302,"female","Native Hawaiian or Other Pacific Islander",6,"Yes",55,"No",7,11,4,22,9,16,21,46,76,96,"No"
40,"female","White",8,"No",85,"Yes",18,17,13,48,12,15,18,45,80,27,"No"
69,"male","Native Hawaiian or Other Pacific Islander",8,"Yes",16,"No",15,16,11,42,10,17,18,45,32,82,"No"
407,"male","Native Hawaiian or Other Pacific Islander",6,"Yes",74,"Yes",18,17,20,55,11,14,17,42,52,100,"Yes"
332,"male","Asian",8,"Yes",95,"Yes",5,10,18,33,16,18,13,47,20,64,"Yes"
572,"male","American Indian or Alaska Native",6,"Yes",62,"Yes",8,12,12,32,15,7,18,40,33,88,"No"
104,"male","Asian",6,"No",86,"Yes",10,8,17,35,14,18,19,51,9,84,"Yes"
205,"male","Black or African American",8,"Yes",92,"No",4,15,13,32,10,3,18,31,91,86,"Yes"
36,"female","Native Hawaiian or Other Pacific Islander",6,"Yes",68,"No",15,15,19,49,10,15,12,37,61,100,"Yes"
24,"male","Black or African American",6,"Yes",74,"No",4,13,9,26,10,7,3,20,54,78,"No"
409,"male","Native Hawaiian or Other Pacific Islander",8,"Yes",63,"No",11,16,20,47,5,7,21,33,8,44,"No"
732,"female","Black or African American",6,"No",86,"Yes",12,18,13,43,17,8,12,37,80,25,"No"
35,"male","Native Hawaiian or Other Pacific Islander",7,"No",86,"Yes",6,14,13,33,17,17,10,44,53,94,"No"
861,"male","Native Hawaiian or Other Pacific Islander",6,"No",81,"Yes",7,4,16,27,16,17,19,52,68,43,"Yes"
823,"female","White",6,"No",90,"Yes",17,12,16,45,14,14,21,49,99,70,"Yes"
949,"female","Native Hawaiian or Other Pacific Islander",7,"No",97,"No",15,16,21,52,9,15,8,32,30,37,"Yes"
110,"male","American Indian or Alaska Native",8,"No",87,"Yes",14,13,4,31,12,10,14,36,11,20,"Yes"
930,"female","American Indian or Alaska Native",6,"Yes",87,"No",15,6,16,37,14,18,12,44,28,30,"No"
998,"female","American Indian or Alaska Native",7,"No",85,"Yes",15,1,14,30,8,4,19,31,85,66,"No"
169,"male","Asian",6,"Yes",88,"No",14,5,17,36,17,14,21,52,68,70,"Yes"
821,"female","White",8,"No",42,"Yes",4,16,17,37,8,3,14,25,16,95,"No"
7,"female","White",8,"No",64,"Yes",14,17,19,50,17,7,20,44,49,60,"No"
90,"female","Asian",8,"No",70,"No",8,13,2,23,12,12,12,36,97,17,"No"
972,"female","White",7,"No",70,"No",17,4,8,29,11,14,15,40,65,66,"No"
97,"male","White",6,"Yes",46,"No",17,15,18,50,10,14,21,45,55,56,"No"
319,"female","Black or African American",7,"Yes",95,"No",11,17,14,42,18,9,18,45,72,58,"No"
306,"female","American Indian or Alaska Native",8,"Yes",84,"Yes",10,1,18,29,14,17,9,40,56,89,"Yes"
461,"male","Native Hawaiian or Other Pacific Islander",7,"No",74,"Yes",3,9,16,28,8,18,21,47,65,89,"No"
427,"female","White",6,"Yes",73,"No",16,2,8,26,6,15,20,41,9,68,"No"
583,"female","American Indian or Alaska Native",8,"No",13,"No",14,15,10,39,13,17,19,49,5,66,"No"
892,"male","American Indian or Alaska Native",6,"No",34,"No",10,17,10,37,17,18,16,51,91,28,"No"
520,"male","Asian",6,"Yes",7,"Yes",11,11,20,42,2,16,18,36,5,82,"No"
401,"male","American Indian or Alaska Native",7,"Yes",83,"No",12,18,4,34,16,11,19,46,81,43,"Yes"
278,"female","White",7,"Yes",83,"Yes",18,16,17,51,9,16,4,29,69,33,"Yes"
688,"female","Native Hawaiian or Other Pacific Islander",8,"Yes",96,"No",14,18,17,49,18,17,21,56,38,71,"Yes"
131,"female","American Indian or Alaska Native",8,"Yes",97,"No",12,14,14,40,11,13,16,40,22,86,"Yes"
915,"male","Native Hawaiian or Other Pacific Islander",7,"No",96,"No",13,16,19,48,5,9,3,17,60,38,"Yes"
562,"male","White",8,"Yes",35,"Yes",7,17,20,44,16,15,20,51,29,63,"Yes"
641,"male","Native Hawaiian or Other Pacific Islander",6,"No",67,"No",9,17,19,45,16,10,15,41,44,79,"No"
334,"female","Asian",6,"Yes",86,"Yes",12,13,19,44,18,8,16,42,43,58,"Yes"
283,"male","Asian",7,"Yes",81,"Yes",6,9,10,25,10,15,17,42,32,80,"No"
674,"male","Black or African American",8,"No",52,"Yes",18,8,15,41,15,11,21,47,63,49,"Yes"
155,"male","Asian",7,"No",95,"Yes",17,7,11,35,11,4,9,24,91,55,"No"
357,"male","White",6,"Yes",34,"Yes",17,14,18,49,13,6,20,39,58,60,"Yes"
62,"male","Black or African American",7,"No",96,"Yes",17,6,21,44,13,7,13,33,13,61,"Yes"
623,"male","White",8,"No",43,"Yes",11,16,14,41,17,12,21,50,74,91,"No"
486,"female","White",7,"Yes",95,"Yes",13,18,12,43,14,8,21,43,42,80,"No"
141,"female","White",7,"No",99,"No",9,9,18,36,5,12,21,38,40,91,"No"
365,"female","Black or African American",7,"Yes",62,"Yes",12,16,21,49,15,11,18,44,2,67,"Yes"
711,"female","Asian",8,"Yes",32,"Yes",15,15,18,48,8,11,14,33,94,63,"Yes"
542,"male","Asian",8,"No",47,"No",11,17,5,33,13,16,18,47,82,21,"Yes"
528,"female","Black or African American",7,"Yes",93,"No",14,9,9,32,14,12,4,30,19,41,"No"
560,"female","American Indian or Alaska Native",7,"No",75,"Yes",12,13,11,36,4,17,11,32,79,99,"No"
294,"female","White",8,"No",22,"No",16,15,20,51,18,13,18,49,63,83,"No"
305,"male","American Indian or Alaska Native",7,"No",71,"No",11,4,10,25,17,15,16,48,27,88,"Yes"
255,"female","Native Hawaiian or Other Pacific Islander",6,"Yes",99,"Yes",6,16,16,38,16,14,21,51,78,74,"Yes"
974,"female","American Indian or Alaska Native",6,"No",63,"No",15,7,11,33,14,18,16,48,4,77,"No"
748,"male","Native Hawaiian or Other Pacific Islander",7,"No",79,"Yes",15,17,5,37,2,6,10,18,27,78,"No"
586,"female","Native Hawaiian or Other Pacific Islander",7,"Yes",22,"No",11,5,2,18,17,15,16,48,27,89,"No"
75,"female","Native Hawaiian or Other Pacific Islander",7,"Yes",64,"Yes",18,7,15,40,14,11,17,42,15,21,"Yes"
752,"female","Native Hawaiian or Other Pacific Islander",7,"No",81,"Yes",4,12,18,34,5,15,14,34,5,52,"Yes"
872,"female","Asian",8,"Yes",34,"Yes",14,5,4,23,9,18,10,37,89,42,"Yes"
388,"male","Asian",7,"Yes",70,"Yes",12,18,9,39,7,17,20,44,35,74,"Yes"
905,"male","American Indian or Alaska Native",6,"Yes",71,"No",17,16,1,34,12,18,10,40,13,24,"Yes"
265,"female","Native Hawaiian or Other Pacific Islander",7,"No",71,"No",12,12,5,29,3,14,4,21,63,5,"Yes"
81,"male","Native Hawaiian or Other Pacific Islander",7,"Yes",96,"Yes",16,14,17,47,10,13,6,29,97,40,"Yes"
939,"female","White",7,"Yes",94,"No",12,14,20,46,12,15,10,37,2,50,"No"
909,"female","Asian",6,"Yes",90,"No",17,13,20,50,2,7,4,13,36,28,"Yes"
907,"female","White",6,"No",84,"No",10,8,21,39,14,14,12,40,47,42,"No"
221,"male","American Indian or Alaska Native",6,"No",12,"No",16,18,15,49,18,12,18,48,18,55,"No"
588,"female","American Indian or Alaska Native",6,"Yes",83,"No",13,17,10,40,7,1,10,18,24,57,"Yes"
966,"male","White",8,"No",99,"Yes",10,16,21,47,13,8,14,35,71,54,"Yes"
855,"male","White",6,"No",75,"No",9,4,13,26,17,7,15,39,65,84,"No"
105,"female","Native Hawaiian or Other Pacific Islander",7,"Yes",53,"No",11,15,16,42,17,17,18,52,88,42,"Yes"
260,"female","White",8,"Yes",47,"No",17,14,8,39,18,14,12,44,12,99,"No"
232,"female","American Indian or Alaska Native",7,"Yes",82,"No",15,8,17,40,13,5,19,37,41,93,"Yes"
653,"female","American Indian or Alaska Native",8,"Yes",44,"No",14,18,10,42,10,13,17,40,44,31,"Yes"
352,"female","Asian",7,"No",86,"No",12,11,9,32,18,18,13,49,10,100,"No"
111,"male","White",8,"No",86,"Yes",18,10,9,37,8,10,15,33,5,100,"Yes"
948,"female","American Indian or Alaska Native",6,"Yes",91,"Yes",12,18,9,39,17,6,10,33,22,32,"No"
115,"male","White",7,"Yes",41,"Yes",17,13,7,37,8,11,18,37,13,69,"No"
686,"female","Black or African American",8,"Yes",89,"Yes",6,9,18,33,18,18,14,50,28,31,"No"
381,"male","Black or African American",8,"Yes",99,"Yes",15,17,4,36,14,14,20,48,36,95,"Yes"
935,"male","American Indian or Alaska Native",6,"No",97,"No",12,9,20,41,15,1,17,33,6,57,"No"
832,"male","Asian",7,"No",95,"Yes",17,10,12,39,7,8,14,29,9,79,"No"
922,"female","Native Hawaiian or Other Pacific Islander",7,"No",31,"Yes",10,13,15,38,16,14,21,51,64,96,"Yes"
690,"male","Asian",6,"Yes",81,"No",16,14,16,46,18,13,6,37,20,90,"Yes"
287,"female","Asian",6,"No",53,"No",6,17,2,25,18,13,21,52,63,30,"No"
577,"female","Native Hawaiian or Other Pacific Islander",7,"No",36,"Yes",16,4,19,39,15,16,19,50,17,74,"No"
755,"female","Asian",6,"Yes",55,"Yes",10,10,12,32,14,15,19,48,74,100,"Yes"
820,"male","White",8,"Yes",94,"No",9,16,12,37,11,6,20,37,77,88,"No"
435,"male","Black or African American",7,"Yes",95,"No",15,17,18,50,5,16,6,27,24,87,"No"
662,"male","Black or African American",7,"No",83,"Yes",17,16,14,47,14,18,19,51,60,93,"Yes"
16,"male","Black or African American",6,"No",6,"Yes",17,16,15,48,7,8,8,23,54,96,"No"
811,"male","Black or African American",6,"Yes",61,"Yes",10,12,16,38,7,8,2,17,72,15,"Yes"
57,"female","Asian",7,"No",87,"Yes",12,9,16,37,18,4,19,41,53,30,"Yes"
561,"female","Asian",8,"Yes",31,"No",4,4,10,18,7,12,9,28,54,65,"No"
891,"female","Native Hawaiian or Other Pacific Islander",6,"Yes",93,"No",16,6,6,28,7,15,11,33,80,26,"No"
324,"male","Asian",6,"No",85,"No",13,5,12,30,15,5,18,38,59,81,"No"
400,"female","American Indian or Alaska Native",8,"No",52,"Yes",18,5,16,39,17,18,17,52,73,69,"Yes"
918,"female","Asian",6,"Yes",73,"Yes",10,18,20,48,1,17,1,19,30,100,"Yes"
1,"female","White",7,"No",92,"Yes",11,12,12,35,17,14,10,41,90,86,"No"
868,"female","Asian",8,"Yes",62,"Yes",15,13,21,49,6,17,16,39,61,88,"No"
969,"male","Black or African American",8,"Yes",84,"Yes",16,17,13,46,15,17,6,38,17,72,"No"
938,"male","American Indian or Alaska Native",6,"Yes",50,"Yes",15,16,21,52,15,6,21,42,69,18,"Yes"
987,"male","Black or African American",6,"No",61,"No",8,7,13,28,13,10,14,37,70,90,"No"
307,"male","American Indian or Alaska Native",8,"Yes",89,"Yes",11,14,18,43,18,13,14,45,17,88,"No"
645,"male","White",7,"Yes",98,"Yes",13,2,12,27,18,14,4,36,87,89,"Yes"
472,"male","Black or African American",6,"Yes",68,"No",17,13,16,46,18,11,20,49,66,37,"No"
343,"female","American Indian or Alaska Native",7,"No",51,"Yes",16,16,13,45,8,17,21,46,41,14,"No"
636,"male","Asian",7,"Yes",54,"No",14,10,15,39,17,15,5,37,53,84,"Yes"
322,"male","American Indian or Alaska Native",6,"No",78,"No",14,11,16,41,9,18,20,47,50,96,"Yes"
153,"male","Native Hawaiian or Other Pacific Islander",6,"Yes",32,"No",16,8,13,37,15,16,5,36,47,83,"Yes"
195,"male","Native Hawaiian or Other Pacific Islander",6,"Yes",100,"No",6,13,21,40,12,10,5,27,27,54,"No"
271,"male","White",8,"Yes",97,"Yes",8,8,21,37,16,14,21,51,69,78,"Yes"
799,"female","American Indian or Alaska Native",8,"Yes",55,"Yes",9,2,14,25,6,11,21,38,11,21,"No"
608,"female","Asian",6,"Yes",58,"No",18,10,3,31,17,18,21,56,16,92,"Yes"
377,"male","American Indian or Alaska Native",7,"No",43,"No",14,17,21,52,18,7,4,29,37,60,"No"
374,"male","American Indian or Alaska Native",7,"Yes",71,"Yes",7,16,6,29,12,10,8,30,96,100,"No"
916,"female","American Indian or Alaska Native",7,"No",65,"No",16,18,12,46,16,11,9,36,12,90,"No"
996,"female","Asian",6,"Yes",44,"Yes",17,18,19,54,13,10,19,42,13,97,"No"
404,"female","Native Hawaiian or Other Pacific Islander",7,"Yes",94,"Yes",3,8,10,21,16,13,20,49,99,93,"No"
556,"female","White",7,"No",86,"No",1,15,10,26,2,3,13,18,66,86,"Yes"
331,"male","Native Hawaiian or Other Pacific Islander",7,"Yes",79,"No",13,8,9,30,15,5,13,33,79,43,"Yes"
487,"male","Native Hawaiian or Other Pacific Islander",6,"No",81,"No",3,7,21,31,9,15,20,44,78,91,"Yes"
995,"female","White",7,"Yes",39,"No",11,10,17,38,14,9,17,40,78,82,"Yes"
843,"male","American Indian or Alaska Native",7,"No",73,"No",15,4,16,35,17,3,12,32,83,90,"Yes"
471,"female","Black or African American",8,"Yes",100,"Yes",14,16,14,44,18,15,9,42,99,55,"No"
735,"female","White",7,"No",43,"No",11,15,13,39,13,16,18,47,84,27,"Yes"
638,"female","Asian",8,"No",81,"No",17,9,10,36,10,14,15,39,24,95,"Yes"
952,"male","White",7,"Yes",84,"Yes",15,18,20,53,7,15,18,40,78,94,"Yes"
311,"female","Native Hawaiian or Other Pacific Islander",6,"No",85,"No",15,15,16,46,17,17,11,45,55,89,"No"
293,"male","Asian",6,"Yes",49,"No",10,14,21,45,15,9,12,36,100,28,"Yes"
575,"male","White",6,"No",91,"No",14,17,17,48,17,16,12,45,72,40,"No"
651,"male","Black or African American",6,"Yes",33,"Yes",14,7,21,42,12,9,17,38,67,17,"Yes"
116,"female","Black or African American",6,"Yes",24,"No",9,16,8,33,10,13,15,38,26,79,"No"
478,"female","Native Hawaiian or Other Pacific Islander",8,"Yes",64,"No",14,11,17,42,7,15,18,40,96,91,"Yes"
898,"female","White",7,"No",79,"Yes",16,17,20,53,16,17,14,47,93,60,"Yes"
139,"male","Asian",8,"No",91,"No",10,3,17,30,17,15,7,39,98,49,"Yes"
594,"female","Asian",8,"No",46,"Yes",18,9,18,45,13,5,5,23,26,54,"No"
903,"male","White",8,"No",88,"No",8,18,20,46,10,14,16,40,21,91,"No"
49,"male","Native Hawaiian or Other Pacific Islander",7,"Yes",38,"Yes",6,17,21,44,10,1,21,32,95,87,"Yes"
978,"male","Black or African American",8,"No",64,"Yes",17,8,19,44,14,8,11,33,96,55,"No"
237,"female","American Indian or Alaska Native",8,"Yes",50,"No",4,17,14,35,10,13,20,43,63,14,"Yes"
839,"female","Black or African American",7,"No",99,"No",12,16,21,49,18,4,15,37,66,96,"Yes"
818,"female","Asian",6,"Yes",57,"Yes",16,14,21,51,13,13,19,45,52,34,"Yes"
634,"female","White",8,"Yes",94,"Yes",15,14,17,46,3,15,2,20,99,9,"No"
618,"male","American Indian or Alaska Native",8,"No",89,"Yes",13,12,4,29,11,10,8,29,91,59,"No"
406,"female","White",7,"No",67,"Yes",9,13,14,36,12,14,19,45,62,62,"No"
737,"male","Asian",8,"Yes",45,"No",7,8,15,30,8,12,13,33,8,46,"Yes"
431,"female","Native Hawaiian or Other Pacific Islander",6,"Yes",93,"No",15,18,16,49,15,9,12,36,92,83,"No"
72,"female","Asian",7,"Yes",41,"Yes",16,13,21,50,11,14,21,46,43,72,"Yes"
442,"male","Asian",6,"Yes",78,"Yes",4,12,15,31,16,12,19,47,9,46,"Yes"
273,"male","Black or African American",8,"Yes",31,"Yes",17,15,18,50,17,11,15,43,75,91,"No"
44,"male","Asian",7,"Yes",13,"No",9,7,14,30,17,16,8,41,37,34,"Yes"
817,"female","White",8,"Yes",80,"No",13,11,16,40,10,15,14,39,61,97,"Yes"
418,"female","Black or African American",7,"Yes",56,"No",14,8,7,29,8,14,9,31,1,64,"No"
397,"male","American Indian or Alaska Native",7,"Yes",40,"Yes",9,14,21,44,10,10,16,36,61,74,"No"
27,"male","American Indian or Alaska Native",7,"No",33,"No",17,15,17,49,9,15,15,39,28,65,"No"
480,"female","Asian",6,"Yes",91,"Yes",3,2,16,21,7,14,10,31,54,21,"No"
685,"female","American Indian or Alaska Native",6,"No",100,"Yes",18,18,15,51,6,18,17,41,30,87,"Yes"
61,"female","American Indian or Alaska Native",7,"Yes",98,"Yes",18,18,17,53,11,17,12,40,15,38,"No"
335,"female","Native Hawaiian or Other Pacific Islander",8,"Yes",80,"No",12,15,14,41,1,18,20,39,33,88,"No"
454,"female","Native Hawaiian or Other Pacific Islander",6,"Yes",88,"No",8,16,18,42,10,7,5,22,8,94,"Yes"
152,"male","American Indian or Alaska Native",6,"Yes",92,"No",13,18,8,39,2,16,21,39,61,74,"No"
669,"male","Native Hawaiian or Other Pacific Islander",8,"Yes",61,"No",15,18,18,51,11,7,21,39,93,51,"Yes"
652,"male","American Indian or Alaska Native",7,"No",97,"Yes",17,8,13,38,18,11,19,48,87,98,"No"
413,"male","Native Hawaiian or Other Pacific Islander",7,"Yes",75,"No",9,15,9,33,10,1,19,30,38,95,"Yes"
484,"female","Black or African American",7,"No",69,"No",14,7,19,40,12,15,21,48,60,96,"Yes"
754,"female","White",6,"Yes",76,"Yes",17,7,19,43,11,2,15,28,46,58,"Yes"
794,"male","Black or African American",8,"No",84,"Yes",18,12,11,41,5,15,17,37,15,100,"Yes"
544,"female","White",7,"Yes",100,"Yes",15,6,18,39,16,18,11,45,27,74,"No"
117,"female","Asian",8,"Yes",45,"No",3,11,19,33,18,6,4,28,46,72,"No"
106,"female","American Indian or Alaska Native",8,"Yes",81,"Yes",18,7,19,44,16,14,14,44,16,81,"No"
320,"female","White",8,"Yes",54,"No",16,16,14,46,12,18,16,46,69,98,"No"
584,"male","White",7,"Yes",37,"Yes",15,8,12,35,18,15,10,43,98,13,"No"
779,"female","White",6,"Yes",85,"No",15,1,10,26,17,12,14,43,70,89,"No"
751,"female","American Indian or Alaska Native",8,"Yes",89,"Yes",18,9,17,44,9,6,19,34,89,86,"Yes"
783,"female","American Indian or Alaska Native",8,"Yes",94,"No",6,18,11,35,6,15,20,41,16,92,"Yes"
10,"female","White",7,"No",94,"No",17,18,17,52,17,18,13,48,29,45,"No"
681,"male","American Indian or Alaska Native",7,"Yes",85,"Yes",11,11,17,39,4,14,18,36,65,61,"No"
13,"female","Native Hawaiian or Other Pacific Islander",6,"No",62,"Yes",1,11,9,21,14,9,12,35,99,92,"No"
439,"male","American Indian or Alaska Native",8,"No",70,"Yes",13,8,12,33,15,5,9,29,95,88,"Yes"
772,"female","White",6,"Yes",72,"Yes",16,11,12,39,11,16,20,47,6,21,"Yes"
338,"female","Asian",7,"Yes",92,"Yes",8,18,11,37,18,5,13,36,73,75,"Yes"
246,"female","Black or African American",8,"No",62,"Yes",13,11,18,42,15,9,21,45,97,73,"Yes"
149,"female","Black or African American",8,"Yes",34,"No",9,16,13,38,11,3,19,33,56,87,"Yes"
76,"male","Asian",7,"Yes",60,"Yes",13,18,6,37,12,11,21,44,16,65,"Yes"
102,"female","Black or African American",8,"No",93,"Yes",9,13,11,33,12,8,12,32,1,28,"Yes"
473,"male","White",8,"No",84,"No",10,3,13,26,3,13,20,36,53,56,"Yes"
731,"male","Native Hawaiian or Other Pacific Islander",8,"Yes",97,"Yes",17,17,20,54,1,17,9,27,22,98,"No"
483,"female","American Indian or Alaska Native",7,"No",52,"Yes",15,11,21,47,6,8,19,33,47,45,"Yes"
910,"female","American Indian or Alaska Native",8,"Yes",15,"No",15,10,7,32,15,18,16,49,12,83,"Yes"
728,"female","Black or African American",6,"No",54,"Yes",13,16,9,38,10,13,19,42,71,86,"Yes"
284,"female","Native Hawaiian or Other Pacific Islander",6,"Yes",87,"Yes",10,11,18,39,6,15,7,28,63,93,"No"
957,"female","Asian",7,"Yes",73,"No",17,6,16,39,14,8,18,40,5,70,"Yes"
145,"male","Asian",7,"Yes",98,"No",18,18,7,43,5,1,16,22,48,54,"No"
727,"female","White",7,"Yes",84,"No",10,9,12,31,14,3,7,24,66,40,"Yes"
733,"male","Asian",8,"No",72,"No",9,14,19,42,13,12,11,36,97,75,"Yes"
362,"male","White",6,"No",77,"No",2,16,19,37,12,7,19,38,91,60,"Yes"
411,"male","White",6,"Yes",80,"Yes",13,10,19,42,16,17,21,54,35,100,"Yes"
526,"female","American Indian or Alaska Native",7,"No",56,"Yes",12,3,6,21,18,14,14,46,93,59,"No"
590,"female","Asian",6,"No",82,"No",10,16,12,38,17,14,20,51,14,55,"Yes"
163,"female","Asian",7,"Yes",92,"No",16,7,16,39,17,8,18,43,33,87,"No"
683,"female","Black or African American",6,"Yes",33,"Yes",10,7,5,22,11,11,19,41,94,86,"No"
327,"female","Native Hawaiian or Other Pacific Islander",7,"No",67,"No",10,12,9,31,14,14,11,39,62,79,"Yes"
146,"male","Asian",7,"Yes",93,"No",15,5,11,31,6,16,11,33,7,84,"No"
225,"female","Black or African American",7,"No",66,"Yes",9,17,7,33,10,16,19,45,15,85,"Yes"
610,"female","Black or African American",8,"Yes",86,"Yes",16,16,9,41,8,11,17,36,72,48,"Yes"
277,"female","American Indian or Alaska Native",7,"No",79,"No",10,11,19,40,8,3,15,26,90,74,"No"
187,"male","White",7,"No",78,"No",17,4,11,32,18,10,8,36,80,67,"No"
607,"female","Native Hawaiian or Other Pacific Islander",6,"Yes",96,"Yes",10,16,20,46,15,15,19,49,63,95,"No"
889,"male","Black or African American",7,"No",78,"No",16,8,16,40,12,13,14,39,16,91,"No"
387,"female","Black or African American",6,"Yes",63,"Yes",16,14,17,47,5,11,21,37,56,43,"No"
553,"male","Native Hawaiian or Other Pacific Islander",7,"No",65,"Yes",17,13,20,50,10,12,7,29,98,100,"No"
142,"female","White",7,"Yes",53,"Yes",14,9,19,42,16,14,9,39,8,32,"No"
965,"male","Asian",6,"No",87,"Yes",16,12,12,40,13,13,21,47,84,86,"Yes"
180,"male","American Indian or Alaska Native",8,"No",46,"Yes",10,18,13,41,15,5,9,29,78,86,"No"
521,"female","Black or African American",8,"Yes",33,"Yes",13,12,11,36,16,16,12,44,77,87,"No"
182,"male","White",7,"Yes",71,"Yes",18,11,16,45,9,15,17,41,2,80,"No"
812,"female","White",8,"No",53,"No",15,17,15,47,6,4,12,22,18,51,"No"
822,"female","Black or African American",6,"Yes",81,"Yes",17,6,18,41,18,10,19,47,44,25,"No"
721,"male","Black or African American",7,"Yes",69,"No",17,17,20,54,11,7,20,38,1,94,"No"
366,"male","White",7,"Yes",58,"No",14,15,12,41,5,18,8,31,83,73,"Yes"
